Script started on Thu 11 Apr 2019 12:39:52 PM PDT
hinert@CF165-18:~/csci241$ git clone git clone https://github.com/CSCI241Spring2 019/lab-1-username[K[K[K[K[K[K[K[K[K[K[K[K[K[K[K[K[K[K[A[C[C[C[C[C[C[C[C[C[C[C[C[C[C[C[C[C[C[C[C[C[C[C[C[C[C[C[C[C[C[C[C[C[C[C[C[C[C[C[C[C[C[C[C[C[C[C[C[C[C[C[C[C[C[C[C[C[C[C[C[C[C[C[C[C[C[C[C[C[C[C[C[C[C[C[C[C[C[C[K
[K[A[C[C[C[C[C[C[C[C[C[C[C[C[C[C[C[C[C[C[C[C[C[C[C[C[C[C[C[C[C[C[C[C[C[C[C[C[C[C[C[C[C[C[C[C[C[C[C[C[C[C[C[C[C[C[C[C[C[C[C[C[C[C[C[C[C[C[C[C[C[C[C[C[C[C[C[C[C[C[C[K[K[K[K[K[K[K[K[K[K[K[K[K[K[K[K[K[K[K[K[K[K[K[K[K[K[K[K[K[K[K[K[K[K[K[K[K[K[K[K[K[K[K[K[K[K[K[K[K[K[K[Kgit clone https://github.com/CSCI241Spring2019/lab-1- trenthiner.git
Cloning into 'lab-1-trenthiner'...
remote: Enumerating objects: 11, done.[K
remote: Counting objects:   9% (1/11)   [Kremote: Counting objects:  18% (2/11)   [Kremote: Counting objects:  27% (3/11)   [Kremote: Counting objects:  36% (4/11)   [Kremote: Counting objects:  45% (5/11)   [Kremote: Counting objects:  54% (6/11)   [Kremote: Counting objects:  63% (7/11)   [Kremote: Counting objects:  72% (8/11)   [Kremote: Counting objects:  81% (9/11)   [Kremote: Counting objects:  90% (10/11)   [Kremote: Counting objects: 100% (11/11)   [Kremote: Counting objects: 100% (11/11), done.[K
remote: Compressing objects:  16% (1/6)   [Kremote: Compressing objects:  33% (2/6)   [Kremote: Compressing objects:  50% (3/6)   [Kremote: Compressing objects:  66% (4/6)   [Kremote: Compressing objects:  83% (5/6)   [Kremote: Compressing objects: 100% (6/6)   [Kremote: Compressing objects: 100% (6/6), done.[K
remote: Total 11 (delta 1), reused 10 (delta 0), pack-reused 0[K
Unpacking objects:   9% (1/11)   Unpacking objects:  18% (2/11)   Unpacking objects:  27% (3/11)   Unpacking objects:  36% (4/11)   Unpacking objects:  45% (5/11)   Unpacking objects:  54% (6/11)   Unpacking objects:  63% (7/11)   Unpacking objects:  72% (8/11)   Unpacking objects:  81% (9/11)   Unpacking objects:  90% (10/11)   Unpacking objects: 100% (11/11)   Unpacking objects: 100% (11/11), done.
Checking connectivity... done.
hinert@CF165-18:~/csci241$ cd lab-1-trenthiner/
hinert@CF165-18:~/csci241/lab-1-trenthiner$ touch writeup.txt [K[K[K[K[K[K[K[K[K[K[K[K[K[K[K[K[K[Kls
build.gradle  src  writeup.txt
hinert@CF165-18:~/csci241/lab-1-trenthiner$ vim writeup.txt 
[?1049h[?1h=[2;1H▽[6n[2;1H  [1;1H]11;?[1;24r[?12;25h[?12l[?25h[27m[23m[m[H[2J[?25l[24;1H"writeup.txt" 0L, 0C[>c[2;1H[94m~                                                                               [3;1H~                                                                               [4;1H~                                                                               [5;1H~                                                                               [6;1H~                                                                               [7;1H~                                                                               [8;1H~                                                                               [9;1H~                                                                               [10;1H~                                                                               [11;1H~                                                                               [12;1H~                                                                               [13;1H~                                                                               [14;1H~                                                                               [15;1H~                                                                               [16;1H~                                                                               [17;1H~                                                                               [18;1H~                                                                               [19;1H~                                                                               [20;1H~                                                                               [21;1H~                                                                               [22;1H~                                                                               [23;1H~                                                                               [m[24;63H0,0-1[9CAll]2;writeup.txt (~/csci241/lab-1-trenthiner) - VIM]1;writeup.txt[1;1H[?12l[?25h[27m[23m[m[H[2J[?25l[2;1H[94m~                                                                               [3;1H~                                                                               [4;1H~                                                                               [5;1H~                                                                               [6;1H~                                                                               [7;1H~                                                                               [8;1H~                                                                               [9;1H~                                                                               [10;1H~                                                                               [11;1H~                                                                               [12;1H~                                                                               [13;1H~                                                                               [14;1H~                                                                               [15;1H~                                                                               [16;1H~                                                                               [17;1H~                                                                               [18;1H~                                                                               [19;1H~                                                                               [20;1H~                                                                               [21;1H~                                                                               [22;1H~                                                                               [23;1H~                                                                               [m[24;63H0,0-1[9CAll"writeup.txt" 0L, 0C[1;1HP+q436f\P+q6b75\P+q6b64\P+q6b72\P+q6b6c\P+q2332\P+q2334\P+q2569\P+q2a37\P+q6b31\[?12l[?25h[?25l[24;1H[1m-- INSERT --[m[24;13H[K[24;63H0,1[11CAll[1;1H[?12l[?25h[?25lT[24;63H1,2]2;writeup.txt + (~/csci241/lab-1-trenthiner) - VIM]1;writeup.txt[1;2H[?12l[?25h[?25lr[24;65H3[1;3H[?12l[?25h[?25le[24;65H4[1;4H[?12l[?25h[?25ln[24;65H5[1;5H[?12l[?25h[?25lt[24;65H6[1;6H[?12l[?25h[?25l[24;65H7[1;7H[?12l[?25h[?25lH[24;65H8[1;8H[?12l[?25h[?25li[24;65H9[1;9H[?12l[?25h[?25ln[24;65H10[1;10H[?12l[?25h[?25le[24;66H1[1;11H[?12l[?25h[?25lr[24;66H2[1;12H[?12l[?25h[24;1H[K[1;11H[?25l[24;63H1,11[10CAll[1;11H[?12l[?25h[?25l[24;63H[K[24;1H:[?12l[?25hw[?25l[?12l[?25hq[?25l[?12l[?25h[?25l"writeup.txt" 1L, 12C written]2;Terminal]1;Terminal
[?1l>[?12l[?25h[?1049lhinert@CF165-18:~/csci241/lab-1-trenthiner$ git commit -m "adde[K[K[K[KAdded part 1 (names [K)  to writeup:[K"
On branch master
Your branch is up-to-date with 'origin/master'.
Changes not staged for commit:
	[31mmodified:   writeup.txt[m

no changes added to commit
hinert@CF165-18:~/csci241/lab-1-trenthiner$ vim writeup.txt
[?1049h[?1h=[2;1H▽[6n[2;1H  [1;1H]11;?[1;24r[?12;25h[?12l[?25h[27m[23m[m[H[2J[?25l[24;1H"writeup.txt" 1L, 12C[>c[1;1HTrent Hiner
[94m~                                                                               [3;1H~                                                                               [4;1H~                                                                               [5;1H~                                                                               [6;1H~                                                                               [7;1H~                                                                               [8;1H~                                                                               [9;1H~                                                                               [10;1H~                                                                               [11;1H~                                                                               [12;1H~                                                                               [13;1H~                                                                               [14;1H~                                                                               [15;1H~                                                                               [16;1H~                                                                               [17;1H~                                                                               [18;1H~                                                                               [19;1H~                                                                               [20;1H~                                                                               [21;1H~                                                                               [22;1H~                                                                               [23;1H~                                                                               [m[24;63H1,1[11CAll]2;writeup.txt (~/csci241/lab-1-trenthiner) - VIM]1;writeup.txt[1;1H[?12l[?25h[27m[23m[m[H[2J[?25l[1;1HTrent Hiner
[94m~                                                                               [3;1H~                                                                               [4;1H~                                                                               [5;1H~                                                                               [6;1H~                                                                               [7;1H~                                                                               [8;1H~                                                                               [9;1H~                                                                               [10;1H~                                                                               [11;1H~                                                                               [12;1H~                                                                               [13;1H~                                                                               [14;1H~                                                                               [15;1H~                                                                               [16;1H~                                                                               [17;1H~                                                                               [18;1H~                                                                               [19;1H~                                                                               [20;1H~                                                                               [21;1H~                                                                               [22;1H~                                                                               [23;1H~                                                                               [m[24;63H1,1[11CAll"writeup.txt" 1L, 12C[1;1HP+q436f\P+q6b75\P+q6b64\P+q6b72\P+q6b6c\P+q2332\P+q2334\P+q2569\P+q2a37\P+q6b31\[?12l[?25h[?25l[24;1H[1m-- INSERT --[m[24;13H[K[24;63H1,1[11CAll[1;1H[?12l[?25h[?25l[24;65H2[1;2H[?12l[?25h[?25l[24;65H3[1;3H[?12l[?25h[?25l[24;65H4[1;4H[?12l[?25h[?25l[24;65H5[1;5H[?12l[?25h[?25l[24;65H6[1;6H[?12l[?25h[?25l[24;65H7[1;7H[?12l[?25h[?25l[24;65H8[1;8H[?12l[?25h[?25l[24;65H9[1;9H[?12l[?25h[?25l[24;65H10[1;10H[?12l[?25h[?25l[24;66H1[1;11H[?12l[?25h[?25l[24;66H2[1;12H[?12l[?25h[?25l[2;1H[K[24;63H2,1 ]2;writeup.txt + (~/csci241/lab-1-trenthiner) - VIM]1;writeup.txt[2;1H[?12l[?25h[?25lH[24;65H2[2;2H[?12l[?25h[?25lo[24;65H3[2;3H[?12l[?25h[?25lb[24;65H4[2;4H[?12l[?25h[?25lb[24;65H5[2;5H[?12l[?25h[?25ly[24;65H6[2;6H[?12l[?25h[?25l:[24;65H7[2;7H[?12l[?25h[?25l[24;65H8[2;8H[?12l[?25h[?25lV[24;65H9[2;9H[?12l[?25h[?25li[24;65H10[2;10H[?12l[?25h[?25ld[24;66H1[2;11H[?12l[?25h[?25le[24;66H2[2;12H[?12l[?25h[?25lo[24;66H3[2;13H[?12l[?25h[?25l[24;66H4[2;14H[?12l[?25h[?25lG[24;66H5[2;15H[?12l[?25h[?25la[24;66H6[2;16H[?12l[?25h[?25lm[24;66H7[2;17H[?12l[?25h[?25le[24;66H8[2;18H[?12l[?25h[?25ls[24;66H9[2;19H[?12l[?25h[24;1H[K[2;18H[?25l[24;63H2,18[10CAll[2;18H[?12l[?25h[?25l[24;63H[K[24;1H:[?12l[?25hw[?25l[?12l[?25hq[?25l[?12l[?25h[?25l"writeup.txt" 2L, 31C written]2;Terminal]1;Terminal
[?1l>[?12l[?25h[?1049lhinert@CF165-18:~/csci241/lab-1-trenthiner$ commit-m "adde[K[K[K[KAdded part 2 (hobby) to wr iteup"
commit-m: command not found
hinert@CF165-18:~/csci241/lab-1-trenthiner$ commit-m "Added part 2 (hobby) to wriiteup"[A[C[C[C[C[C[C[C[C[C[C[C[C[C[C[C[C[C[C[C[C[C[C[C[C[C[C[C[C[C[C[C[C[C[C[C[C[C[C[21Pvim writeup.txt
[K[A[C[C[C[C[C[C[C[C[C[C[C[C[C[C[C[C[C[C[C[C[C[C[C[C[C[C[C[C[C[C[C[C[C[C[C[C[C[C[C[C[C[C[C[C[C[C[C[C[C[C[C[C[C[C[C[C[C[C[Ccommit-m "Added part 2 (hobby) to wriiteup"[A[C[C[C[C[C[C[C[C[C[C[C[C[C[C[C[C[C[C[C[C[C[C[C[C[C[C[C[C[C[C[C[C[C[C[C[C[C[C[C[C[C[C[C[C[C[C[C[C[C[C[C[C[C[C[C[C[C[C[C[C[C[C[C[C[C[C[C[C[C[C[C[C[C[C[C[C[C[C[C -m "Added part 2 (hobby) to writeup"[A[C[C[C[C[C[C[C[C[C[C[C[C[C[C[C[C[C[C[C[C[C[C[C[C[C[C[C[C[C[C[C[C[C[C[C[C[C[C[C[C[C[C[C[C

commit: command not found
hinert@CF165-18:~/csci241/lab-1-trenthiner$ vim writeup.txt 
[?1049h[?1h=[2;1H▽[6n[2;1H  [1;1H]11;?[1;24r[?12;25h[?12l[?25h[27m[23m[m[H[2J[?25l[24;1H"writeup.txt" 2L, 31C[>c[1;1HTrent Hiner
Hobby: Video Games
[94m~                                                                               [4;1H~                                                                               [5;1H~                                                                               [6;1H~                                                                               [7;1H~                                                                               [8;1H~                                                                               [9;1H~                                                                               [10;1H~                                                                               [11;1H~                                                                               [12;1H~                                                                               [13;1H~                                                                               [14;1H~                                                                               [15;1H~                                                                               [16;1H~                                                                               [17;1H~                                                                               [18;1H~                                                                               [19;1H~                                                                               [20;1H~                                                                               [21;1H~                                                                               [22;1H~                                                                               [23;1H~                                                                               [m[24;63H1,1[11CAll]2;writeup.txt (~/csci241/lab-1-trenthiner) - VIM]1;writeup.txt[1;1H[?12l[?25h[27m[23m[m[H[2J[?25l[1;1HTrent Hiner
Hobby: Video Games
[94m~                                                                               [4;1H~                                                                               [5;1H~                                                                               [6;1H~                                                                               [7;1H~                                                                               [8;1H~                                                                               [9;1H~                                                                               [10;1H~                                                                               [11;1H~                                                                               [12;1H~                                                                               [13;1H~                                                                               [14;1H~                                                                               [15;1H~                                                                               [16;1H~                                                                               [17;1H~                                                                               [18;1H~                                                                               [19;1H~                                                                               [20;1H~                                                                               [21;1H~                                                                               [22;1H~                                                                               [23;1H~                                                                               [m[24;63H1,1[11CAll"writeup.txt" 2L, 31C[1;1HP+q436f\P+q6b75\P+q6b64\P+q6b72\P+q6b6c\P+q2332\P+q2334\P+q2569\P+q2a37\P+q6b31\[?12l[?25h[?25l[24;1H[K[24;1H:[?12l[?25hw[?25l[?12l[?25hq[?25l[?12l[?25h[?25l"writeup.txt" 2L, 31C written]2;Terminal]1;Terminal
[?1l>[?12l[?25h[?1049lhinert@CF165-18:~/csci241/lab-1-trenthiner$ git commit - m "Added part 2 (hobby)  to writeup"
error: pathspec '-' did not match any file(s) known to git.
error: pathspec 'm' did not match any file(s) known to git.
error: pathspec 'Added part 2 (hobby) to writeup' did not match any file(s) known to git.
hinert@CF165-18:~/csci241/lab-1-trenthiner$ git commit - m "Added part 2 (hobby)  to writeup"[A[C[C[C[C[C[C[C[C[C[C[C[C[C[C[C[C[C[C[C[C[C[C[C[C[C[C[C[C[C[C[C[C[C[C[C[C[C[C[C[C[C[C[C[C[C[C[C[C[C[C[C[C[C[C[C[C[C[C[C[C[C[C[C[C[C[C[C[C[C[C[C[C[C[C[C[C[C[C[C[C[C m "Added part 2 (hobby) t[1P[A[C[C[C[C[C[C[C[C[C[C[C[C[C[C[C[C[C[C[C[C[C[C[C[C[C[C[C[C[C[C[C[C[C[C[C[C[C[C[C[C[C[C[C[C[C[C[C[C[C[C[C[C[C[C

error: pathspec 'm' did not match any file(s) known to git.
error: pathspec 'Added part 2 (hobby) to writeup' did not match any file(s) known to git.
hinert@CF165-18:~/csci241/lab-1-trenthiner$ git commit  m "Added part 2 (hobby) tto writeup"[K[K[K[K[K[K[K[K[K[K[K[A[C[C[C[C[C[C[C[C[C[C[C[C[C[C[C[C[C[C[C[C[C[C[C[C[C[C[C[C[C[C[C[C[C[C[C[C[C[C[C[C[C[C[C[C[C[C[C[C[C[C[C[C[C[C[C[C[C[C[C[C[C[C[C[C[C[C[C[C[C[C[C[C[C[C[C[C[C[C[C[K
[K[A[C[C[C[C[C[C[C[C[C[C[C[C[C[C[C[C[C[C[C[C[C[C[C[C[C[C[C[C[C[C[C[C[C[C[C[C[C[C[C[C[C[C[C[C[C[C[C[C[C[C[C[C[C[C[C[C[C[C[C[C[C[C[C[C[C[C[C[C[C[C[C[C[C[C[C[C[C[C[C[K[K[K[K[K[K[K[K[K[K[K[K[K[K[K[K[K[K[K[K[K[K[K[K[K[K[K[K[K[K[K[K[K[K[Kgit add [K[K[K[K[K[K[K[Kgit commit - m "Added part 2 (hobby)  to writeup"[A[C[C[C[C[C[C[C[C[C[C[C[C[C[C[C[C[C[C[C[C[C[C[C[C[C[C[C[C[C[C[C[C[20Pvim writeup.txt 
[K[A[C[C[C[C[C[C[C[C[C[C[C[C[C[C[C[C[C[C[C[C[C[C[C[C[C[C[C[C[C[C[C[C[C[C[C[C[C[C[C[C[C[C[C[C[C[C[C[C[C[C[C[C[C[C[C[C[C[C[C[Ccommit -m "Added part 2 (hobby) to wrriteup"[A[C[C[C[C[C[C[C[C[C[C[C[C[C[C[C[C[C[C[C[C[C[C[C[C[C[C[C[C[C[C[C[C[C[C[C[C[C[C[C[C[C[C[C[C[C-m "Added part 2 (hobby) to wri[1Pteup"[A[C[C[C[C[C[C[C[C[C[C[C[C[C[C[C[C[C[C[C[C[C[C[C[C[C[C[C[C[C[C[C[C[C[C[C[C[C[C[21Pvim writeup.txt
[K[A[C[C[C[C[C[C[C[C[C[C[C[C[C[C[C[C[C[C[C[C[C[C[C[C[C[C[C[C[C[C[C[C[C[C[C[C[C[C[C[C[C[C[C[C[C[C[C[C[C[C[C[C[C[C[C[C[C[C[Cgit commit -m "Added part 1 (names) tto writeup"[A[C[C[C[C[C[C[C[C[C[C[C[C[C[C[C[C[C[C[C[C[C[C[C[C[C[C[C[C[C[C[C[C[C[C[C[C[C[C[C[C[C[C[C[C[C[C[C[C[C[C[C[C[C[C[C[C[C[C[C[C[C[C[C[C[C[C[C[C[C[C[C[C[C[C[C[C[C[C[C[C[C[C[C[C[C[C[C[C[Cs) to[1P writeup"[A[C[C[C[C[C[C[C[C[C[C[C[C[C[C[C[C[C[C[C[C[C[C[C[C[C[C[C[C[C[C[C[C[C[C[C[C[C[C[C[C[C[C[C[C[C[C[C[C[C[C[C[C[C[C[C[C[C[C[C[C[C[C[C[C[C[Cs) to [1Pwriteup"[A[C[C[C[C[C[C[C[C[C[C[C[C[C[C[C[C[C[C[C[C[C[C[C[C[C[C[C[C[C[C[C[C[C[C[C[C[C[C[C[C[C[C[C[C[C[C[C[C[C[C[C[C[C[C[C[C[C[C[C[C[C[C[C[C[C[Cs) to w[1Priteup"[A[C[C[C[C[C[C[C[C[C[C[C[C[C[C[C[C[C[C[C[C[C[C[C[C[C[C[C[C[C[C[C[C[C[C[C[C[C[C[C[C[C[C[C[C[C[C[C[C[C[C[C[C[C[C[C[C[C[C[C[C[C[C[C[C[C[Cs) to wr[1Piteup"[A[C[C[C[C[C[C[C[C[C[C[C[C[C[C[C[C[C[C[C[C[C[C[C[C[C[C[C[C[C[C[C[C[C[C[C[C[C[C[C[C[C[C[C[C[C[C[C[C[C[C[C[C[C[C[C[C[C[C[C[C[C[C[C[C[C[C) to wri[1Pteup"[A[C[C[C[C[C[C[C[C[C[C[C[C[C[C[C[C[C[C[C[C[C[C[C[C[C[C[C[C[C[C[C[C[C[C[C[C[C[C[C[C[C[C[C[C[C[C[C[C[C[C[C[C[C[C[C[C[C[C[C[C[C[C[C[C[C[C[Ch) to writeup"[A[C[C[C[C[C[C[C[C[C[C[C[C[C[C[C[C[C[C[C[C[C[C[C[C[C[C[C[C[C[C[C[C[C[C[C[C[C[C[C[C[C[C[C[C[C[C[C[C[C[C[C[C[C[C[C[C[C[C[C[C[C[C[C[C[C[C[Co) to writeup"[A[C[C[C[C[C[C[C[C[C[C[C[C[C[C[C[C[C[C[C[C[C[C[C[C[C[C[C[C[C[C[C[C[C[C[C[C[C[C[C[C[C[C[C[C[C[C[C[C[C[C[C[C[C[C[C[C[C[C[C[C[C[C[C[C[C[C[Cb) to writeup"[A[C[C[C[C[C[C[C[C[C[C[C[C[C[C[C[C[C[C[C[C[C[C[C[C[C[C[C[C[C[C[C[C[C[C[C[C[C[C[C[C[C[C[C[C[C[C[C[C[C[C[C[C[C[C[C[C[C[C[C[C[C[C[C[C[C[C[Cb) to writeup"[A[C[C[C[C[C[C[C[C[C[C[C[C[C[C[C[C[C[C[C[C[C[C[C[C[C[C[C[C[C[C[C[C[C[C[C[C[C[C[C[C[C[C[C[C[C[C[C[C[C[C[C[C[C[C[C[C[C[C[C[C[C[C[C[C[C[C[Cy) to writeup"[A[C[C[C[C[C[C[C[C[C[C[C[C[C[C[C[C[C[C[C[C[C[C[C[C[C[C[C[C[C[C[C[C[C[C[C[C[C[C[C[C[C[C[C[C[C[C[C[C[C[C[C[C[C[C[C[C[C[C[C[C[C[C[C[C[C[C[C

On branch master
Your branch is up-to-date with 'origin/master'.
Changes not staged for commit:
	[31mmodified:   writeup.txt[m

no changes added to commit
hinert@CF165-18:~/csci241/lab-1-trenthiner$ git commit -m "Added part 1 (hobby) tto writeup"[A[C[C[C[C[C[C[C[C[C[C[C[C[C[C[C[C[C[C[C[C[C[C[C[C[C[C[C[C[C[C[C[C[C[K
[K[A[C[C[C[C[C[C[C[C[C[C[C[C[C[C[C[C[C[C[C[C[C[C[C[C[C[C[C[C[C[C[C[C[C[C[C[C[C[C[C[C[C[C[C[Cgit commit writeup.txt [K[K[K[K[K[K[K[K[K[K[K[K[K[K[K[K[K[K[Kadd we[Kriteup.txt 
hinert@CF165-18:~/csci241/lab-1-trenthiner$ git add writeup.txt commit -m "Added part 1 (hobby) tto writeup"
[master 1c1a853] Added part 1 (hobby) to writeup
 1 file changed, 2 insertions(+)
hinert@CF165-18:~/csci241/lab-1-trenthiner$ git push writeup.txt 
warning: push.default is unset; its implicit value has changed in
Git 2.0 from 'matching' to 'simple'. To squelch this message
and maintain the traditional behavior, use:

  git config --global push.default matching

To squelch this message and adopt the new behavior now, use:

  git config --global push.default simple

When push.default is set to 'matching', git will push local branches
to the remote branches that already exist with the same name.

Since Git 2.0, Git defaults to the more conservative 'simple'
behavior, which only pushes the current branch to the corresponding
remote branch that 'git pull' uses to update the current branch.

See 'git help config' and search for 'push.default' for further information.
(the 'simple' mode was introduced in Git 1.7.11. Use the similar mode
'current' instead of 'simple' if you sometimes use older versions of Git)

fatal: Invalid gitfile format: writeup.txt
fatal: Could not read from remote repository.

Please make sure you have the correct access rights
and the repository exists.
hinert@CF165-18:~/csci241/lab-1-trenthiner$ git push origin master
Username for 'https://github.com': hinert      trenthiner
Password for 'https://trenthiner@github.com': 
remote: Invalid username or password.
fatal: Authentication failed for 'https://github.com/CSCI241Spring2019/lab-1-trenthiner.git/'
hinert@CF165-18:~/csci241/lab-1-trenthiner$ git push origin master
Username for 'https://github.com': trenthiner
Password for 'https://trenthiner@github.com': 
Counting objects: 3, done.
Delta compression using up to 8 threads.
Compressing objects:  50% (1/2)   Compressing objects: 100% (2/2)   Compressing objects: 100% (2/2), done.
Writing objects:  33% (1/3)   Writing objects:  66% (2/3)   Writing objects: 100% (3/3)   Writing objects: 100% (3/3), 289 bytes | 0 bytes/s, done.
Total 3 (delta 1), reused 0 (delta 0)
remote: Resolving deltas:   0% (0/1)   [Kremote: Resolving deltas: 100% (1/1)   [Kremote: Resolving deltas: 100% (1/1), completed with 1 local object.[K
To https://github.com/CSCI241Spring2019/lab-1-trenthiner.git
   7d3b285..1c1a853  master -> master
hinert@CF165-18:~/csci241/lab-1-trenthiner$ vim writeup.txt 
[?1049h[?1h=[2;1H▽[6n[2;1H  [1;1H]11;?[1;24r[?12;25h[?12l[?25h[27m[23m[m[H[2J[?25l[24;1H"writeup.txt" 2L, 31C[>c[1;1HTrent Hiner
Hobby: Video Games
[94m~                                                                               [4;1H~                                                                               [5;1H~                                                                               [6;1H~                                                                               [7;1H~                                                                               [8;1H~                                                                               [9;1H~                                                                               [10;1H~                                                                               [11;1H~                                                                               [12;1H~                                                                               [13;1H~                                                                               [14;1H~                                                                               [15;1H~                                                                               [16;1H~                                                                               [17;1H~                                                                               [18;1H~                                                                               [19;1H~                                                                               [20;1H~                                                                               [21;1H~                                                                               [22;1H~                                                                               [23;1H~                                                                               [m[24;63H1,1[11CAll]2;writeup.txt (~/csci241/lab-1-trenthiner) - VIM]1;writeup.txt[1;1H[?12l[?25h[27m[23m[m[H[2J[?25l[1;1HTrent Hiner
Hobby: Video Games
[94m~                                                                               [4;1H~                                                                               [5;1H~                                                                               [6;1H~                                                                               [7;1H~                                                                               [8;1H~                                                                               [9;1H~                                                                               [10;1H~                                                                               [11;1H~                                                                               [12;1H~                                                                               [13;1H~                                                                               [14;1H~                                                                               [15;1H~                                                                               [16;1H~                                                                               [17;1H~                                                                               [18;1H~                                                                               [19;1H~                                                                               [20;1H~                                                                               [21;1H~                                                                               [22;1H~                                                                               [23;1H~                                                                               [m[24;63H1,1[11CAll"writeup.txt" 2L, 31C[1;1HP+q436f\P+q6b75\P+q6b64\P+q6b72\P+q6b6c\P+q2332\P+q2334\P+q2569\P+q2a37\P+q6b31\[?12l[?25h[?25l[24;1H[K[24;1H:[?12l[?25hw[?25l[?12l[?25hq[?25l[?12l[?25h[?25l"writeup.txt" 2L, 31C written]2;Terminal]1;Terminal
[?1l>[?12l[?25h[?1049lhinert@CF165-18:~/csci241/lab-1-trenthiner$ touch username.tex[K[Kxt
hinert@CF165-18:~/csci241/lab-1-trenthiner$ vim username.txt 
[?1049h[?1h=[2;1H▽[6n[2;1H  [1;1H]11;?[1;24r[?12;25h[?12l[?25h[27m[23m[m[H[2J[?25l[24;1H"username.txt" 0L, 0C[>c[2;1H[94m~                                                                               [3;1H~                                                                               [4;1H~                                                                               [5;1H~                                                                               [6;1H~                                                                               [7;1H~                                                                               [8;1H~                                                                               [9;1H~                                                                               [10;1H~                                                                               [11;1H~                                                                               [12;1H~                                                                               [13;1H~                                                                               [14;1H~                                                                               [15;1H~                                                                               [16;1H~                                                                               [17;1H~                                                                               [18;1H~                                                                               [19;1H~                                                                               [20;1H~                                                                               [21;1H~                                                                               [22;1H~                                                                               [23;1H~                                                                               [m[24;63H0,0-1[9CAll]2;username.txt (~/csci241/lab-1-trenthiner) - VIM]1;username.txt[1;1H[?12l[?25h[27m[23m[m[H[2J[?25l[2;1H[94m~                                                                               [3;1H~                                                                               [4;1H~                                                                               [5;1H~                                                                               [6;1H~                                                                               [7;1H~                                                                               [8;1H~                                                                               [9;1H~                                                                               [10;1H~                                                                               [11;1H~                                                                               [12;1H~                                                                               [13;1H~                                                                               [14;1H~                                                                               [15;1H~                                                                               [16;1H~                                                                               [17;1H~                                                                               [18;1H~                                                                               [19;1H~                                                                               [20;1H~                                                                               [21;1H~                                                                               [22;1H~                                                                               [23;1H~                                                                               [m[24;63H0,0-1[9CAll"username.txt" 0L, 0C[1;1HP+q436f\P+q6b75\P+q6b64\P+q6b72\P+q6b6c\P+q2332\P+q2334\P+q2569\P+q2a37\P+q6b31\[?12l[?25h[?25l[24;1H[97m[41mE35: No previous regular expression[m[24;63H[K[24;63H0,0-1[9CAll[1;1H[?12l[?25h[?25l[24;1H[1m-- INSERT --[m[24;13H[K[24;63H0,1[11CAll[1;1H[?12l[?25h[?25lT[24;63H1,2]2;username.txt + (~/csci241/lab-1-trenthiner) - VIM]1;username.txt[1;2H[?12l[?25h[?25lr[24;65H3[1;3H[?12l[?25h[?25le[24;65H4[1;4H[?12l[?25h[?25ln[24;65H5[1;5H[?12l[?25h[?25lt[24;65H6[1;6H[?12l[?25h[?25l[24;65H7[1;7H[?12l[?25h[?25lH[24;65H8[1;8H[?12l[?25h[?25li[24;65H9[1;9H[?12l[?25h[?25ln[24;65H10[1;10H[?12l[?25h[?25le[24;66H1[1;11H[?12l[?25h[?25lr[24;66H2[1;12H[?12l[?25h[?25l,[24;66H3[1;13H[?12l[?25h[?25l[24;66H4[1;14H[?12l[?25h[?25lh[24;66H5[1;15H[?12l[?25h[?25li[24;66H6[1;16H[?12l[?25h[?25ln[24;66H7[1;17H[?12l[?25h[?25le[24;66H8[1;18H[?12l[?25h[?25lr[24;66H9[1;19H[?12l[?25h[?25lt[24;65H20[1;20H[?12l[?25h[?25l,[24;66H1[1;21H[?12l[?25h[?25l[24;66H2[1;22H[?12l[?25h[?25lt[24;66H3[1;23H[?12l[?25h[?25lr[24;66H4[1;24H[?12l[?25h[?25le[24;66H5[1;25H[?12l[?25h[?25ln[24;66H6[1;26H[?12l[?25h[?25lt[24;66H7[1;27H[?12l[?25h[?25lh[24;66H8[1;28H[?12l[?25h[?25li[24;66H9[1;29H[?12l[?25h[?25ln[24;65H30[1;30H[?12l[?25h[?25le[24;66H1[1;31H[?12l[?25h[?25lr[24;66H2[1;32H[?12l[?25h[24;1H[K[1;31H[?25l[24;63H1,31[10CAll[1;31H[?12l[?25h[?25l[24;63H[K[24;1H:[?12l[?25hw[?25l[?12l[?25hq[?25l[?12l[?25h[?25l"username.txt" 1L, 32C written]2;Terminal]1;Terminal
[?1l>[?12l[?25h[?1049lhinert@CF165-18:~/csci241/lab-1-trenthiner$ git commit -,vim username.txt touch username.txt[2Pvim writeup.txt git push origin master[1Pwriteup.txt commit -m "Added part 1 (hobby) tto writeup"[1Pp"[1Pp"[1Pp"[1Pp"[1Pp"[1Pp"[1Pp"[1Pp"[1Pp"[A[C[C[C[C[C[C[C[C[C[C[C[C[C[C[C[C[C[C[C[C[C[C[C[C[C[C[C[C[C[C[C[C[C[C[C[C[C[C[C[C[C[C[C[C[C[C[C[C[C[C[C[C[C[C[C[C[C[C[C[C[C[C[C[C[C[C[C[C[C[C[C[C[C[C[C[C[C[C[Cp"[K[A[C[C[C[C[C[C[C[C[C[C[C[C[C[C[C[C[C[C[C[C[C[C[C[C[C[C[C[C[C[C[C[C[C[C[C[C[C[C[C[C[C[C[C[C[C[C[C[C[C[C[C[C[C[C[C[C[C[C[C[C[C[C[C[C[C[C[C[C[C[C[C[C[C[C[C[C[C[Cp" [K[A[C[C[C[C[C[C[C[C[C[C[C[C[C[C[C[C[C[C[C[C[C[C[C[C[C[C[C[C[C[C[C[C[C[C[C[C[C[C[C[C[C[C[C[C[C[C[C[C[C[C[C[C[C[C[C[C[C[C[C[C[C[C[C[C[C[C[C[C[C[C[C[C[C[C[C[C[C[C[1Pp"
[K[A[C[C[C[C[C[C[C[C[C[C[C[C[C[C[C[C[C[C[C[C[C[C[C[C[C[C[C[C[C[C[C[C[C[C[C[C[C[C[C[C[C[C[C[C[C[C[C[C[C[C[C[C[C[C[C[C[C[C[C[C[C[C[C[C[C[C[C[C[C[C[C[C[C[C[C[C[C[1Pp"[1Pp"[1Pp"[1Pp"[1Pp"[1Pp"[1Pp"[1Pp"[1Pp"[1Pp"[1Pp"[1P"[1Pp"[1Pp"[1Pp"[1Pp"[1Pp"[1Pp"[1P"A"d"d"e"d" "u"s"e"r"n"a"m"e"s" "t"o" "u" [A[C[C[C[C[C[C[C[C[C[C[C[C[C[C[C[C[C[C[C[C[C[C[C[C[C[C[C[C[C[C[C[C[C[C[C[C[C[C[C[C[C[C[C[C[C[C[C[C[C[C[C[C[C[C[C[C[C[C[C[C[C[C[C[C[C[C[C[C[C[C[C[C[C[C[C[C[C[Cs""e"r"n"a"m"e"."t"e"[1P"x"t"
On branch master
Your branch is up-to-date with 'origin/master'.
Untracked files:
	[31musername.txt[m

nothing added to commit but untracked files present
hinert@CF165-18:~/csci241/lab-1-trenthiner$ git push origin master
Username for 'https://github.com': trenthiner
Password for 'https://trenthiner@github.com': 
Everything up-to-date
hinert@CF165-18:~/csci241/lab-1-trenthiner$ add username.txt 
No command 'add' found, did you mean:
 Command 'hadd' from package 'root-system-bin' (universe)
 Command 'and' from package 'and' (universe)
 Command 'aid' from package 'id-utils' (universe)
 Command 'amd' from package 'am-utils' (universe)
 Command 'adb' from package 'adb' (universe)
 Command 'adb' from package 'android-tools-adb' (universe)
 Command 'ddd' from package 'ddd' (universe)
 Command 'ad' from package 'netatalk' (universe)
 Command 'atd' from package 'at' (main)
 Command 'adbd' from package 'android-tools-adbd' (universe)
 Command 'ldd' from package 'libc-bin' (main)
 Command 'axd' from package 'afnix' (universe)
 Command 'dd' from package 'coreutils' (main)
 Command 'tdd' from package 'devtodo' (universe)
add: command not found
hinert@CF165-18:~/csci241/lab-1-trenthiner$ git add username.txt 
hinert@CF165-18:~/csci241/lab-1-trenthiner$ git push origin master
Username for 'https://github.com': trenthiner
Password for 'https://trenthiner@github.com': 
Everything up-to-date
hinert@CF165-18:~/csci241/lab-1-trenthiner$ ls
build.gradle  src  username.txt  writeup.txt
hinert@CF165-18:~/csci241/lab-1-trenthiner$ git add username.txt
hinert@CF165-18:~/csci241/lab-1-trenthiner$ git add username.txtls[Kgit push origin master[1Padd username.txt [4P[C[C[C[C[C[C[C[C[C[C[C[C[C[C[C[C[Cgit push origin mastercommit -m "Added usernames to useername.txt"
[master eb6750c] Added usernames to username.txt
 1 file changed, 1 insertion(+)
 create mode 100644 username.txt
hinert@CF165-18:~/csci241/lab-1-trenthiner$ git push origin master
Username for 'https://github.com': hiner     trenthiner
Password for 'https://trenthiner@github.com': 
Counting objects: 3, done.
Delta compression using up to 8 threads.
Compressing objects:  50% (1/2)   Compressing objects: 100% (2/2)   Compressing objects: 100% (2/2), done.
Writing objects:  33% (1/3)   Writing objects:  66% (2/3)   Writing objects: 100% (3/3)   Writing objects: 100% (3/3), 370 bytes | 0 bytes/s, done.
Total 3 (delta 0), reused 0 (delta 0)
To https://github.com/CSCI241Spring2019/lab-1-trenthiner.git
   1c1a853..eb6750c  master -> master
hinert@CF165-18:~/csci241/lab-1-trenthiner$ git log
[?1h=[33mcommit eb6750cd3e74e146a0782d26227608ce36b54f47[m[m
Author: hinert <hinert@wwu.edu>[m
Date:   Thu Apr 11 12:50:46 2019 -0700[m
[m
    Added usernames to username.txt[m
[m
[33mcommit 1c1a85385d5fec69c28f1a92c9a56bf6e31dea41[m[m
Author: hinert <hinert@wwu.edu>[m
Date:   Thu Apr 11 12:46:13 2019 -0700[m
[m
    Added part 1 (hobby) to writeup[m
[m
[33mcommit 7d3b2854d166144702905812eec5d0681b720c76[m[m
Author: hinert <hinert@wwu.edu>[m
Date:   Thu Apr 11 12:13:04 2019 -0700[m
[m
    Added empty writeup[m
[m
[33mcommit 1523c09e41bb264a6f420fcd78d1a7d6e44a5340[m[m
Author: majeskn <majeskn@wwu.edu>[m
Date:   Mon Jan 7 20:49:19 2019 -0800[m
[m
    Adding setup for gradle[m
:[K[K[K:[K[K:[K[K[7mNo next tag  (press RETURN)[27m[24;1H[K[K:[K[K[K[?1l>hinert@CF165-18:~/csci241/lab-1-trenthiner$ if[K[Kgid[Kt diff
[?1h=[K[?1l>hinert@CF165-18:~/csci241/lab-1-trenthiner$ git checkout writeup.txt [K[K[K[K[K[K[K[K[K[K[K[K[K[K[K[K[K[K[K[K[K[K[K[K[Kget checkout writeup.txt 
No command 'get' found, but there are 18 similar ones
get: command not found
hinert@CF165-18:~/csci241/lab-1-trenthiner$ git checkout writeup.txt 
hinert@CF165-18:~/csci241/lab-1-trenthiner$ git reset writeup.txt 
hinert@CF165-18:~/csci241/lab-1-trenthiner$ vim writeup.txt 
[?1049h[?1h=[2;1H▽[6n[2;1H  [1;1H]11;?[1;24r[?12;25h[?12l[?25h[27m[23m[m[H[2J[?25l[24;1H"writeup.txt" 2L, 31C[>c[1;1HTrent Hiner
Hobby: Video Games
[94m~                                                                               [4;1H~                                                                               [5;1H~                                                                               [6;1H~                                                                               [7;1H~                                                                               [8;1H~                                                                               [9;1H~                                                                               [10;1H~                                                                               [11;1H~                                                                               [12;1H~                                                                               [13;1H~                                                                               [14;1H~                                                                               [15;1H~                                                                               [16;1H~                                                                               [17;1H~                                                                               [18;1H~                                                                               [19;1H~                                                                               [20;1H~                                                                               [21;1H~                                                                               [22;1H~                                                                               [23;1H~                                                                               [m[24;63H1,1[11CAll]2;writeup.txt (~/csci241/lab-1-trenthiner) - VIM]1;writeup.txt[1;1H[?12l[?25h[27m[23m[m[H[2J[?25l[1;1HTrent Hiner
Hobby: Video Games
[94m~                                                                               [4;1H~                                                                               [5;1H~                                                                               [6;1H~                                                                               [7;1H~                                                                               [8;1H~                                                                               [9;1H~                                                                               [10;1H~                                                                               [11;1H~                                                                               [12;1H~                                                                               [13;1H~                                                                               [14;1H~                                                                               [15;1H~                                                                               [16;1H~                                                                               [17;1H~                                                                               [18;1H~                                                                               [19;1H~                                                                               [20;1H~                                                                               [21;1H~                                                                               [22;1H~                                                                               [23;1H~                                                                               [m[24;63H1,1[11CAll"writeup.txt" 2L, 31C[1;1HP+q436f\P+q6b75\P+q6b64\P+q6b72\P+q6b6c\P+q2332\P+q2334\P+q2569\P+q2a37\P+q6b31\[?12l[?25h[?25l[24;1H[K[24;1H:[?12l[?25hq[?25l[?12l[?25h[?25l]2;Terminal]1;Terminal[24;1H[K[24;1H[?1l>[?12l[?25h[?1049lhinert@CF165-18:~/csci241/lab-1-trenthiner$ touch dummyfile.txt
hinert@CF165-18:~/csci241/lab-1-trenthiner$ ls
build.gradle  dummyfile.txt  src  username.txt	writeup.txt
hinert@CF165-18:~/csci241/lab-1-trenthiner$ git mc[Kv dummyfile.txt testreset.txt
fatal: not under version control, source=dummyfile.txt, destination=testreset.txt
hinert@CF165-18:~/csci241/lab-1-trenthiner$ git checkout
Your branch is up-to-date with 'origin/master'.
hinert@CF165-18:~/csci241/lab-1-trenthiner$ git reset
hinert@CF165-18:~/csci241/lab-1-trenthiner$ git rm dummyfile.txt 
fatal: pathspec 'dummyfile.txt' did not match any files
hinert@CF165-18:~/csci241/lab-1-trenthiner$ ls
build.gradle  dummyfile.txt  src  username.txt	writeup.txt
hinert@CF165-18:~/csci241/lab-1-trenthiner$ git rm dummyfile.txt 
fatal: pathspec 'dummyfile.txt' did not match any files
hinert@CF165-18:~/csci241/lab-1-trenthiner$ git mv writeup.txt  [Kt[Kl[K
usage: git mv [<options>] <source>... <destination>

    -v, --verbose         be verbose
    -n, --dry-run         dry run
    -f, --force           force move/rename even if target exists
    -k                    skip move/rename errors

hinert@CF165-18:~/csci241/lab-1-trenthiner$ ls
build.gradle  dummyfile.txt  src  username.txt	writeup.txt
hinert@CF165-18:~/csci241/lab-1-trenthiner$ git branch
* [32mmaster[m
hinert@CF165-18:~/csci241/lab-1-trenthiner$ git chc[Keckout master
Already on 'master'
Your branch is up-to-date with 'origin/master'.
hinert@CF165-18:~/csci241/lab-1-trenthiner$ get[K[Kit checkout <master>
bash: syntax error near unexpected token `newline'
hinert@CF165-18:~/csci241/lab-1-trenthiner$ git checkout <master>[K[K[K[K[K[K[K[Kmaster
Already on 'master'
Your branch is up-to-date with 'origin/master'.
hinert@CF165-18:~/csci241/lab-1-trenthiner$ gi [Kt reset master
hinert@CF165-18:~/csci241/lab-1-trenthiner$ ls
build.gradle  dummyfile.txt  src  username.txt	writeup.txt
hinert@CF165-18:~/csci241/lab-1-trenthiner$ mkdir testmove
hinert@CF165-18:~/csci241/lab-1-trenthiner$ ls
build.gradle  dummyfile.txt  src  testmove  username.txt  writeup.txt
hinert@CF165-18:~/csci241/lab-1-trenthiner$ ls
build.gradle  dummyfile.txt  src  testmove  username.txt  writeup.txt
hinert@CF165-18:~/csci241/lab-1-trenthiner$ git mv dummyfile.txt  testmove/
fatal: not under version control, source=dummyfile.txt, destination=testmove/dummyfile.txt
hinert@CF165-18:~/csci241/lab-1-trenthiner$ ls
build.gradle  dummyfile.txt  src  testmove  username.txt  writeup.txt
hinert@CF165-18:~/csci241/lab-1-trenthiner$ git mov[K[Kv dummyfile.txt testmove/[K
fatal: not under version control, source=dummyfile.txt, destination=testmove/dummyfile.txt
hinert@CF165-18:~/csci241/lab-1-trenthiner$ vs[K[Kls
build.gradle  dummyfile.txt  src  testmove  username.txt  writeup.txt
hinert@CF165-18:~/csci241/lab-1-trenthiner$ git status
On branch master
Your branch is up-to-date with 'origin/master'.
Untracked files:
  (use "git add <file>..." to include in what will be committed)

	[31mdummyfile.txt[m

nothing added to commit but untracked files present (use "git add" to track)
hinert@CF165-18:~/csci241/lab-1-trenthiner$ git mc[Kv dummyfile.txt testmove/[K[K[K[K[K[K[K[K[K[K[K[K[K[K[K[K[K[K[K[K[K[K[K[K[K[K[K[K[K[Kcd testmove/
hinert@CF165-18:~/csci241/lab-1-trenthiner/testmove$ ls
hinert@CF165-18:~/csci241/lab-1-trenthiner/testmove$ csd[K[Kd ..
hinert@CF165-18:~/csci241/lab-1-trenthiner$ ls
build.gradle  dummyfile.txt  src  testmove  username.txt  writeup.txt
hinert@CF165-18:~/csci241/lab-1-trenthiner$ git mc[Kv dummyfile.txt testmove/dummyf ile.txt
fatal: not under version control, source=dummyfile.txt, destination=testmove/dummyfile.txt
hinert@CF165-18:~/csci241/lab-1-trenthiner$ git mv dummyfile.txt testmove/dummyfiile.txt[K[K[K[K[K[K[K[A[C[C[C[C[C[C[C[C[C[C[C[C[C[C[C[C[C[C[C[C[C[C[C[C[C[C[C[C[C[C[C[C[C[C[C[C[C[C[C[C[C[C[C[C[C[C[C[C[C[C[C[C[C[C[C[C[C[C[C[C[C[C[C[C[C[C[C[C[C[C[C[C[C[C[C[C[C[C[C[K
[K[A[C[C[C[C[C[C[C[C[C[C[C[C[C[C[C[C[C[C[C[C[C[C[C[C[C[C[C[C[C[C[C[C[C[C[C[C[C[C[C[C[C[C[C[C[C[C[C[C[C[C[C[C[C[C[C[C[C[C[C[C[C[C[C[C[C[C[C[C[C[C[C[C[C[C[C[C[C[C[C[K[K[K[K[K[K[K[K[K[K[K[K[K[K[K[K[K[K[K[K[K[K[K[K[K[K[K[K[K[K[K[K[K[K[Kcd testmove/
hinert@CF165-18:~/csci241/lab-1-trenthiner/testmove$ touch renamen[Kme.txt
hinert@CF165-18:~/csci241/lab-1-trenthiner/testmove$ cd ..
hinert@CF165-18:~/csci241/lab-1-trenthiner$ ls
build.gradle  dummyfile.txt  src  testmove  username.txt  writeup.txt
hinert@CF165-18:~/csci241/lab-1-trenthiner$ git mv dummyfile.txt testmove/renamemme.txt 
fatal: not under version control, source=dummyfile.txt, destination=testmove/renameme.txt
hinert@CF165-18:~/csci241/lab-1-trenthiner$ ls
build.gradle  dummyfile.txt  src  testmove  username.txt  writeup.txt
hinert@CF165-18:~/csci241/lab-1-trenthiner$ git blame
usage: git blame [<options>] [<rev-opts>] [<rev>] [--] <file>

    <rev-opts> are documented in git-rev-list(1)

    --incremental         Show blame entries as we find them, incrementally
    -b                    Show blank SHA-1 for boundary commits (Default: off)
    --root                Do not treat root commits as boundaries (Default: off)
    --show-stats          Show work cost statistics
    --score-debug         Show output score for blame entries
    -f, --show-name       Show original filename (Default: auto)
    -n, --show-number     Show original linenumber (Default: off)
    -p, --porcelain       Show in a format designed for machine consumption
    --line-porcelain      Show porcelain format with per-line commit information
    -c                    Use the same output mode as git-annotate (Default: off)
    -t                    Show raw timestamp (Default: off)
    -l                    Show long commit SHA1 (Default: off)
    -s                    Suppress author name and timestamp (Default: off)
    -e, --show-email      Show author email instead of name (Default: off)
    -w                    Ignore whitespace differences
    --minimal             Spend extra cycles to find better match
    -S <file>             Use revisions from <file> instead of calling git-rev-list
    --contents <file>     Use <file>'s contents as the final image
    -C[<score>]           Find line copies within and across files
    -M[<score>]           Find line movements within and across files
    -L <n,m>              Process only line range n,m, counting from 1
    --abbrev[=<n>]        use <n> digits to display SHA-1s

hinert@CF165-18:~/csci241/lab-1-trenthiner$ git mv dummyfile.txt testmove/
fatal: not under version control, source=dummyfile.txt, destination=testmove/dummyfile.txt
hinert@CF165-18:~/csci241/lab-1-trenthiner$ git mv dummyfile.txt testmove/renamemme.txt 
fatal: not under version control, source=dummyfile.txt, destination=testmove/renameme.txt
hinert@CF165-18:~/csci241/lab-1-trenthiner$ [Khinert@CF165-18:~/csci241/lab-1-trenthiner$ add dummyfile.txt [K[K[K[K[K[K[K[K[K[K[K[K[K[K[K[K[K[Kgit add dummyfile.txt 
hinert@CF165-18:~/csci241/lab-1-trenthiner$ git add dummyfile.txt [21@mv dummyfile.txt testmove/renamem[C[C[C[C[C[C[K
hinert@CF165-18:~/csci241/lab-1-trenthiner$ ls
build.gradle  src  testmove  username.txt  writeup.txt
hinert@CF165-18:~/csci241/lab-1-trenthiner$ cd testmove/
hinert@CF165-18:~/csci241/lab-1-trenthiner/testmove$ ls
dummyfile.txt  renameme.txt
hinert@CF165-18:~/csci241/lab-1-trenthiner/testmove$ git add renameme.txt 
hinert@CF165-18:~/csci241/lab-1-trenthiner/testmove$ git rm 
dummyfile.txt  renameme.txt   
hinert@CF165-18:~/csci241/lab-1-trenthiner/testmove$ git rm 
dummyfile.txt  renameme.txt   
hinert@CF165-18:~/csci241/lab-1-trenthiner/testmove$ git rm dummyfile.txt 
error: the following file has changes staged in the index:
    testmove/dummyfile.txt
(use --cached to keep the file, or -f to force removal)
hinert@CF165-18:~/csci241/lab-1-trenthiner/testmove$ cd..[K[K  [K..
hinert@CF165-18:~/csci241/lab-1-trenthiner$ ls
build.gradle  src  testmove  username.txt  writeup.txt
hinert@CF165-18:~/csci241/lab-1-trenthiner$ git rm testmove/[K[K[K[K[K[K[K[K[K[K -f testmove/
fatal: not removing 'testmove/' recursively without -r
hinert@CF165-18:~/csci241/lab-1-trenthiner$ git rm -f testmove/[1@r[1P testmove/
error: the following files have changes staged in the index:
    testmove/dummyfile.txt
    testmove/renameme.txt
(use --cached to keep the file, or -f to force removal)
hinert@CF165-18:~/csci241/lab-1-trenthiner$ git rm -r testmove/[C testmove/- testmove/f testmove/
rm 'testmove/dummyfile.txt'
rm 'testmove/renameme.txt'
hinert@CF165-18:~/csci241/lab-1-trenthiner$ git rm -r -f testmove/[K[K[K[K[K[K[K[K[K[K[K[K[K[K[K-f tem[Kstmove/dummf[Kuf[K[Kyfile.txt
fatal: pathspec 'testmove/dummyfile.txt' did not match any files
hinert@CF165-18:~/csci241/lab-1-trenthiner$ git rm -f testmove/dummyfile.txt[K[K[K[K[K[K[K[K[K[K[K[K[K[K[K[K[K[K[K[K[K[K[K[K[K[K[K[K[K[K[K[Kcd testmove
bash: cd: testmove: No such file or directory
hinert@CF165-18:~/csci241/lab-1-trenthiner$ cd testmove[K[K[K[K[K[K[K[K[K[K[Kls
build.gradle  src  username.txt  writeup.txt
hinert@CF165-18:~/csci241/lab-1-trenthiner$ git lgo
git: 'lgo' is not a git command. See 'git --help'.

Did you mean this?
	log
hinert@CF165-18:~/csci241/lab-1-trenthiner$ git log
[?1h=[33mcommit eb6750cd3e74e146a0782d26227608ce36b54f47[m[m
Author: hinert <hinert@wwu.edu>[m
Date:   Thu Apr 11 12:50:46 2019 -0700[m
[m
    Added usernames to username.txt[m
[m
[33mcommit 1c1a85385d5fec69c28f1a92c9a56bf6e31dea41[m[m
Author: hinert <hinert@wwu.edu>[m
Date:   Thu Apr 11 12:46:13 2019 -0700[m
[m
    Added part 1 (hobby) to writeup[m
[m
[33mcommit 7d3b2854d166144702905812eec5d0681b720c76[m[m
Author: hinert <hinert@wwu.edu>[m
Date:   Thu Apr 11 12:13:04 2019 -0700[m
[m
    Added empty writeup[m
[m
[33mcommit 1523c09e41bb264a6f420fcd78d1a7d6e44a5340[m[m
Author: majeskn <majeskn@wwu.edu>[m
Date:   Mon Jan 7 20:49:19 2019 -0800[m
[m
    Adding setup for gradle[m
:[K[K[K:[K[K[K[?1l>hinert@CF165-18:~/csci241/lab-1-trenthiner$ t[Kgit dif writeup.txt 
git: 'dif' is not a git command. See 'git --help'.

Did you mean one of these?
	diff
	config
	difftool
	init
hinert@CF165-18:~/csci241/lab-1-trenthiner$ git dif writeup.txt [1@f
[?1h=[K[?1l>hinert@CF165-18:~/csci241/lab-1-trenthiner$ git diff writeup.txt writeup.txt 
[?1h=[K[?1l>hinert@CF165-18:~/csci241/lab-1-trenthiner$ ls
build.gradle  src  username.txt  writeup.txt
hinert@CF165-18:~/csci241/lab-1-trenthiner$ vim username.txt 
[?1049h[?1h=[2;1H▽[6n[2;1H  [1;1H]11;?[1;24r[?12;25h[?12l[?25h[27m[23m[m[H[2J[?25l[24;1H"username.txt" 1L, 32C[>c[1;1HTrent Hiner, hinert, trenthiner
[94m~                                                                                                            [3;1H~                                                                                                            [4;1H~                                                                                                            [5;1H~                                                                                                            [6;1H~                                                                                                            [7;1H~                                                                                                            [8;1H~                                                                                                            [9;1H~                                                                                                            [10;1H~                                                                                                            [11;1H~                                                                                                            [12;1H~                                                                                                            [13;1H~                                                                                                            [14;1H~                                                                                                            [15;1H~                                                                                                            [16;1H~                                                                                                            [17;1H~                                                                                                            [18;1H~                                                                                                            [19;1H~                                                                                                            [20;1H~                                                                                                            [21;1H~                                                                                                            [22;1H~                                                                                                            [23;1H~                                                                                                            [m[24;92H1,1[11CAll]2;username.txt (~/csci241/lab-1-trenthiner) - VIM]1;username.txt[1;1H[?12l[?25h[27m[23m[m[H[2J[?25l[1;1HTrent Hiner, hinert, trenthiner
[94m~                                                                                                            [3;1H~                                                                                                            [4;1H~                                                                                                            [5;1H~                                                                                                            [6;1H~                                                                                                            [7;1H~                                                                                                            [8;1H~                                                                                                            [9;1H~                                                                                                            [10;1H~                                                                                                            [11;1H~                                                                                                            [12;1H~                                                                                                            [13;1H~                                                                                                            [14;1H~                                                                                                            [15;1H~                                                                                                            [16;1H~                                                                                                            [17;1H~                                                                                                            [18;1H~                                                                                                            [19;1H~                                                                                                            [20;1H~                                                                                                            [21;1H~                                                                                                            [22;1H~                                                                                                            [23;1H~                                                                                                            [m[24;92H1,1[11CAll"username.txt" 1L, 32C[1;1HP+q436f\P+q6b75\P+q6b64\P+q6b72\P+q6b6c\P+q2332\P+q2334\P+q2569\P+q2a37\P+q6b31\[?12l[?25h[?25l[24;1H[K[24;1H:[?12l[?25hq[?25l[?12l[?25h[?25l]2;Terminal]1;Terminal[24;1H[K[24;1H[?1l>[?12l[?25h[?1049lhinert@CF165-18:~/csci241/lab-1-trenthiner$ vim writeup.txt 
[?1049h[?1h=[2;1H▽[6n[2;1H  [1;1H]11;?[1;24r[?12;25h[?12l[?25h[27m[23m[m[H[2J[?25l[24;1H"writeup.txt" 2L, 31C[>c[1;1HTrent Hiner
Hobby: Video Games
[94m~                                                                                                            [4;1H~                                                                                                            [5;1H~                                                                                                            [6;1H~                                                                                                            [7;1H~                                                                                                            [8;1H~                                                                                                            [9;1H~                                                                                                            [10;1H~                                                                                                            [11;1H~                                                                                                            [12;1H~                                                                                                            [13;1H~                                                                                                            [14;1H~                                                                                                            [15;1H~                                                                                                            [16;1H~                                                                                                            [17;1H~                                                                                                            [18;1H~                                                                                                            [19;1H~                                                                                                            [20;1H~                                                                                                            [21;1H~                                                                                                            [22;1H~                                                                                                            [23;1H~                                                                                                            [m[24;92H1,1[11CAll]2;writeup.txt (~/csci241/lab-1-trenthiner) - VIM]1;writeup.txt[1;1H[?12l[?25h[27m[23m[m[H[2J[?25l[1;1HTrent Hiner
Hobby: Video Games
[94m~                                                                                                            [4;1H~                                                                                                            [5;1H~                                                                                                            [6;1H~                                                                                                            [7;1H~                                                                                                            [8;1H~                                                                                                            [9;1H~                                                                                                            [10;1H~                                                                                                            [11;1H~                                                                                                            [12;1H~                                                                                                            [13;1H~                                                                                                            [14;1H~                                                                                                            [15;1H~                                                                                                            [16;1H~                                                                                                            [17;1H~                                                                                                            [18;1H~                                                                                                            [19;1H~                                                                                                            [20;1H~                                                                                                            [21;1H~                                                                                                            [22;1H~                                                                                                            [23;1H~                                                                                                            [m[24;92H1,1[11CAll"writeup.txt" 2L, 31C[1;1HP+q436f\P+q6b75\P+q6b64\P+q6b72\P+q6b6c\P+q2332\P+q2334\P+q2569\P+q2a37\P+q6b31\[?12l[?25h[?25l[24;1H[K[24;1H:[?12l[?25hq[?25l[?12l[?25h[?25l]2;Terminal]1;Terminal[24;1H[K[24;1H[?1l>[?12l[?25h[?1049lhinert@CF165-18:~/csci241/lab-1-trenthiner$ ls
build.gradle  src  username.txt  writeup.txt
hinert@CF165-18:~/csci241/lab-1-trenthiner$ git checkout -n[Kb question3
Switched to a new branch 'question3'
hinert@CF165-18:~/csci241/lab-1-trenthiner$ ls
build.gradle  src  username.txt  writeup.txt
hinert@CF165-18:~/csci241/lab-1-trenthiner$ vim writeup.txt 
[?1049h[?1h=[2;1H▽[6n[2;1H  [1;1H]11;?[1;24r[?12;25h[?12l[?25h[27m[23m[m[H[2J[?25l[24;1H"writeup.txt" 2L, 31C[>c[1;1HTrent Hiner
Hobby: Video Games
[94m~                                                                                                            [4;1H~                                                                                                            [5;1H~                                                                                                            [6;1H~                                                                                                            [7;1H~                                                                                                            [8;1H~                                                                                                            [9;1H~                                                                                                            [10;1H~                                                                                                            [11;1H~                                                                                                            [12;1H~                                                                                                            [13;1H~                                                                                                            [14;1H~                                                                                                            [15;1H~                                                                                                            [16;1H~                                                                                                            [17;1H~                                                                                                            [18;1H~                                                                                                            [19;1H~                                                                                                            [20;1H~                                                                                                            [21;1H~                                                                                                            [22;1H~                                                                                                            [23;1H~                                                                                                            [m[24;92H1,1[11CAll]2;writeup.txt (~/csci241/lab-1-trenthiner) - VIM]1;writeup.txt[1;1H[?12l[?25h[27m[23m[m[H[2J[?25l[1;1HTrent Hiner
Hobby: Video Games
[94m~                                                                                                            [4;1H~                                                                                                            [5;1H~                                                                                                            [6;1H~                                                                                                            [7;1H~                                                                                                            [8;1H~                                                                                                            [9;1H~                                                                                                            [10;1H~                                                                                                            [11;1H~                                                                                                            [12;1H~                                                                                                            [13;1H~                                                                                                            [14;1H~                                                                                                            [15;1H~                                                                                                            [16;1H~                                                                                                            [17;1H~                                                                                                            [18;1H~                                                                                                            [19;1H~                                                                                                            [20;1H~                                                                                                            [21;1H~                                                                                                            [22;1H~                                                                                                            [23;1H~                                                                                                            [m[24;92H1,1[11CAll"writeup.txt" 2L, 31C[1;1HP+q436f\P+q6b75\P+q6b64\P+q6b72\P+q6b6c\P+q2332\P+q2334\P+q2569\P+q2a37\P+q6b31\[?12l[?25h[?25l[24;92H2[2;1H[?12l[?25h[?25l[24;94H2[2;2H[?12l[?25h[?25l[24;94H3[2;3H[?12l[?25h[?25l[24;94H4[2;4H[?12l[?25h[?25l[24;94H3[2;3H[?12l[?25h[?25l[24;94H2[2;2H[?12l[?25h[?25l[24;94H1[2;1H[?12l[?25h[?25l[24;94H2[2;2H[?12l[?25h[?25l[24;94H3[2;3H[?12l[?25h[?25l[24;94H4[2;4H[?12l[?25h[?25l[24;94H5[2;5H[?12l[?25h[?25l[24;94H6[2;6H[?12l[?25h[?25l[24;94H7[2;7H[?12l[?25h[?25l[24;94H8[2;8H[?12l[?25h[?25l[24;94H9[2;9H[?12l[?25h[?25l[24;94H10[2;10H[?12l[?25h[?25l[24;95H1[2;11H[?12l[?25h[?25l[24;95H2[2;12H[?12l[?25h[?25l[24;95H3[2;13H[?12l[?25h[?25l[24;95H4[2;14H[?12l[?25h[?25l[24;95H5[2;15H[?12l[?25h[?25l[24;95H6[2;16H[?12l[?25h[?25l[24;95H7[2;17H[?12l[?25h[?25l[24;95H8[2;18H[?12l[?25h[?25l[24;1H[1m-- INSERT --[m[24;13H[K[24;92H2,18[10CAll[2;18H[?12l[?25h[?25l[2;18H[K[3;1Hs[3;2H[K[24;92H3,1 ]2;writeup.txt + (~/csci241/lab-1-trenthiner) - VIM]1;writeup.txt[3;1H[?12l[?25h[?25l[2;18Hs
[94m~                                                                                                            [m[24;92H2,18[2;18H[?12l[?25h[?25l[24;95H9[2;19H[?12l[?25h[?25l[3;1H[K[24;92H3,1 [3;1H[?12l[?25h[?25lF[24;94H2[3;2H[?12l[?25h[?25la[24;94H3[3;3H[?12l[?25h[?25lv[24;94H4[3;4H[?12l[?25h[?25lo[24;94H5[3;5H[?12l[?25h[?25lr[24;94H6[3;6H[?12l[?25h[?25li[24;94H7[3;7H[?12l[?25h[?25lt[24;94H8[3;8H[?12l[?25h[?25l[24;94H9[3;9H[?12l[?25h[?25l[24;94H8[3;8H[?12l[?25h[?25le[24;94H9[3;9H[?12l[?25h[?25l[24;94H10[3;10H[?12l[?25h[?25lS[24;95H1[3;11H[?12l[?25h[?25lo[24;95H2[3;12H[?12l[?25h[?25ln[24;95H3[3;13H[?12l[?25h[?25lg[24;95H4[3;14H[?12l[?25h[?25l:[24;95H5[3;15H[?12l[?25h[?25l[24;95H6[3;16H[?12l[?25h[?25lG[24;95H7[3;17H[?12l[?25h[?25lf[24;95H8[3;18H[?12l[?25h[?25lo[24;95H9[3;19H[?12l[?25h[?25lu[24;94H20[3;20H[?12l[?25h[?25ln[24;95H1[3;21H[?12l[?25h[?25ld[24;95H2[3;22H[?12l[?25h[?25l[3;21H[K[24;95H1[3;21H[?12l[?25h[?25l[3;20H[K[24;95H0[3;20H[?12l[?25h[?25l[3;19H[K[24;94H19[3;19H[?12l[?25h[?25l[3;18H[K[24;95H8[3;18H[?12l[?25h[?25l[3;17H[K[24;95H7[3;17H[?12l[?25h[?25lr[24;95H8[3;18H[?12l[?25h[?25lu[24;95H9[3;19H[?12l[?25h[?25l[3;18H[K[24;95H8[3;18H[?12l[?25h[?25lo[24;95H9[3;19H[?12l[?25h[?25lu[24;94H20[3;20H[?12l[?25h[?25ln[24;95H1[3;21H[?12l[?25h[?25ld[24;95H2[3;22H[?12l[?25h[?25l[24;95H3[3;23H[?12l[?25h[?25lv[24;95H4[3;24H[?12l[?25h[?25lb[24;95H5[3;25H[?12l[?25h[?25l[3;24H[K[24;95H4[3;24H[?12l[?25h[?25l[3;23H[K[24;95H3[3;23H[?12l[?25h[?25lb[24;95H4[3;24H[?12l[?25h[?25ly[24;95H5[3;25H[?12l[?25h[?25l[24;95H6[3;26H[?12l[?25h[?25lW[24;95H7[3;27H[?12l[?25h[?25la[24;95H8[3;28H[?12l[?25h[?25ll[24;95H9[3;29H[?12l[?25h[?25ll[24;94H30[3;30H[?12l[?25h[?25lo[24;95H1[3;31H[?12l[?25h[?25lw[24;95H2[3;32H[?12l[?25h[?25ls[24;95H3[3;33H[?12l[?25h[24;1H[K[3;32H[?25l[24;92H3,32[10CAll[3;32H[?12l[?25h[?25l[24;92H[K[24;1H:[?12l[?25hw[?25l[?12l[?25hq[?25l[?12l[?25h[?25l"writeup.txt" 3L, 64C written]2;Terminal]1;Terminal
[?1l>[?12l[?25h[?1049lhinert@CF165-18:~/csci241/lab-1-trenthiner$ add writeup.txt 
No command 'add' found, did you mean:
 Command 'and' from package 'and' (universe)
 Command 'tdd' from package 'devtodo' (universe)
 Command 'ad' from package 'netatalk' (universe)
 Command 'adbd' from package 'android-tools-adbd' (universe)
 Command 'atd' from package 'at' (main)
 Command 'adb' from package 'android-tools-adb' (universe)
 Command 'adb' from package 'adb' (universe)
 Command 'ldd' from package 'libc-bin' (main)
 Command 'hadd' from package 'root-system-bin' (universe)
 Command 'axd' from package 'afnix' (universe)
 Command 'dd' from package 'coreutils' (main)
 Command 'amd' from package 'am-utils' (universe)
 Command 'ddd' from package 'ddd' (universe)
 Command 'aid' from package 'id-utils' (universe)
add: command not found
hinert@CF165-18:~/csci241/lab-1-trenthiner$ git add writeup.txt 
hinert@CF165-18:~/csci241/lab-1-trenthiner$ push[K[K[K[Kcommit -m "added artist/[K[K[K[K[K[K[K[K[Kd faco[K[Kvorite song/artist to wrie[1@g[1@i[1@t[1@ [C[C[C[C[C[C[C[C[C[C[C[C[C[C[C[C[C[C[C[C[C[C[C[C[C[C[C[C[C[C[C[C[C[C[C[C[C[C[C[C[C[C[C[C[1Pete[Ce[K[K[Kiteup.txt"
[question3 accae62] added favorite song/artist to writeup.txt
 1 file changed, 1 insertion(+)
hinert@CF165-18:~/csci241/lab-1-trenthiner$ git merge qustion3[K[K[K[K[K[K[Kuestion3
Already up-to-date.
hinert@CF165-18:~/csci241/lab-1-trenthiner$ git checkout master
Switched to branch 'master'
Your branch is up-to-date with 'origin/master'.
hinert@CF165-18:~/csci241/lab-1-trenthiner$ git merge question3
Updating eb6750c..accae62
Fast-forward
 writeup.txt | 1 [32m+[m
 1 file changed, 1 insertion(+)
hinert@CF165-18:~/csci241/lab-1-trenthiner$ i[Kgit as[Kdd [K[K[K[K[K[K[K[Kgit push [K origin master
Username for 'https://github.com': trenthiner
Password for 'https://trenthiner@github.com': 
Counting objects: 3, done.
Delta compression using up to 8 threads.
Compressing objects:  33% (1/3)   Compressing objects:  66% (2/3)   Compressing objects: 100% (3/3)   Compressing objects: 100% (3/3), done.
Writing objects:  33% (1/3)   Writing objects:  66% (2/3)   Writing objects: 100% (3/3)   Writing objects: 100% (3/3), 330 bytes | 0 bytes/s, done.
Total 3 (delta 1), reused 0 (delta 0)
remote: Resolving deltas:   0% (0/1)   [Kremote: Resolving deltas: 100% (1/1)   [Kremote: Resolving deltas: 100% (1/1), completed with 1 local object.[K
To https://github.com/CSCI241Spring2019/lab-1-trenthiner.git
   eb6750c..accae62  master -> master
hinert@CF165-18:~/csci241/lab-1-trenthiner$ git branch de[K[K-delete[K[K[K[K[K[K-delte [K[K[Kete question3
Deleted branch question3 (was accae62).
hinert@CF165-18:~/csci241/lab-1-trenthiner$ ls
build.gradle  src  username.txt  writeup.txt
hinert@CF165-18:~/csci241/lab-1-trenthiner$ grade build
No command 'grade' found, did you mean:
 Command 'grace' from package 'grace' (universe)
 Command 'grads' from package 'grads' (universe)
 Command 'gradle' from package 'gradle' (universe)
 Command 'glade' from package 'glade' (universe)
grade: command not found
hinert@CF165-18:~/csci241/lab-1-trenthiner$ gradle build
[0m
Welcome to Gradle 5.0!

Here are the highlights of this release:
 - Kotlin DSL 1.0
 - Task timeouts
 - Dependency alignment aka BOM support
 - Interactive `gradle init`

For more details see https://docs.gradle.org/5.0/release-notes.html

Starting a Gradle Daemon (subsequent builds will be faster)


[2A[1B[1m> Starting Daemon[m[17D[1B[1A[1m> Starting Daemon[m[17D[1B[1A[1m> Starting Daemon[m[17D[1B[1A[1m> Starting Daemon[m[17D[1B[1A[1m> Starting Daemon[m[17D[1B[1A[1m> Starting Daemon[m[17D[1B[1A[1m> Starting Daemon[m[17D[1B[1A[1m> Starting Daemon[m[17D[1B[1A[1m> Starting Daemon[m[17D[1B[1A> IDLE[0K[6D[1B[2A[1m<[0;32;1;0;39;1m-------------> 0% INITIALIZING [0s][m[36D[1B[1m> Evaluating settings[m[21D[1B[2A[1m<[0;32;1;0;39;1m-------------> 0% INITIALIZING [0s][m[36D[1B[1m> Evaluating settings[m[21D[1B[2A[1m<[0;32;1;0;39;1m-------------> 0% INITIALIZING [0s][m[36D[1B[1m> Evaluating settings[m[21D[1B[2A[1m<[0;32;1;0;39;1m-------------> 0% INITIALIZING [0s][m[36D[1B[1m> Evaluating settings[m[21D[1B[2A[1m<[0;32;1;0;39;1m-------------> 0% CONFIGURING [0s][m[0K[35D[1B[1m> Loading projects[m[0K[18D[1B[2A[1m<[0;32;1;0;39;1m-------------> 0% CONFIGURING [0s][m[35D[1B[1m> root project[m[0K[14D[1B[2A[1m<[0;32;1;0;39;1m-------------> 0% CONFIGURING [0s][m[35D[1B[1m> root project > Compiling /home/hinert/csci241/lab-1-trenthiner/build.gradle into local compilation cache >[m[108D[1B[2A[1m<[0;32;1;0;39;1m-------------> 0% CONFIGURING [0s][m[35D[1B[1m> root project > Compiling /home/hinert/csci241/lab-1-trenthiner/build.gradle into local compilation cache >[m[108D[1B[2A[1m<[0;32;1;0;39;1m-------------> 0% CONFIGURING [0s][m[35D[1B[1m> root project[m[0K[14D[1B[2A[1m<[0;32;1;0;39;1m-------------> 0% CONFIGURING [0s][m[35D[1B[1m> root project[m[14D[1B[2A[1m<[0;32;1;0;39;1m-------------> 0% CONFIGURING [1s][m[35D[1B[1m> root project[m[14D[1B[2A[1m<[0;32;1;0;39;1m-------------> 0% CONFIGURING [1s][m[35D[1B[1m> root project[m[14D[1B[2A[1m<[0;32;1;0;39;1m-------------> 0% CONFIGURING [1s][m[35D[1B[1m> root project[m[14D[1B[2A[1m<[0;32;1m=============[0;39;1m> 100% CONFIGURING [1s][m[37D[1B> IDLE[0K[6D[1B[2A[1m<[0;32;1m=============[0;39;1m> 100% CONFIGURING [1s][m[37D[2B[2A[1m<[0;32;1m=============[0;39;1m> 100% CONFIGURING [1s][m[37D[2B[2A[1m<[0;32;1;0;39;1m-------------> 0% EXECUTING [1s][m[0K[33D[1B[1m> :compileJava[m[14D[1B[2A[1m<[0;32;1;0;39;1m-------------> 0% EXECUTING [1s][m[33D[1B[1m> :compileJava[m[14D[1B[2A[1m<[0;32;1;0;39;1m-------------> 0% EXECUTING [1s][m[33D[1B[1m> :compileJava[m[14D[1B[2A[1m<[0;32;1m===[0;39;1m----------> 28% EXECUTING [1s][m[34D[1B[1m> :startScripts[m[15D[1B[2A[1m<[0;32;1m===[0;39;1m----------> 28% EXECUTING [2s][m[34D[1B[1m> :startScripts[m[15D[1B[2A[0K
[32;1mBUILD SUCCESSFUL[0;39m in 4s
5 actionable tasks: 5 executed
[0K
[0K
[2A[1m<[0;32;1;0;39;1m-------------> 0% WAITING[m[26D[1B> IDLE[6D[1B[2A[1m<[0;32;1;0;39;1m-------------> 0% WAITING[m[26D[2B[2A[2K[1B[2K[1A[0mhinert@CF165-18:~/csci241/lab-1-trenthiner$ gradle run
[0m

[1A[1m> Connecting to Daemon[m[22D[1B[2A[1m<[0;32;1m=========[0;39;1m----> 75% EXECUTING [0s][m[34D[1B[1m> :run[m[0K[6D[1B[2A[0K
[1m> Task :run[m
Hello World!

[32;1mBUILD SUCCESSFUL[0;39m in 0s
2 actionable tasks: 1 executed, 1 up-to-date
[0K
[0K
[2A[1m<[0;32;1;0;39;1m-------------> 0% WAITING[m[26D[1B[1m> :run[m[6D[1B[2A[2K[1B[2K[1A[0mhinert@CF165-18:~/csci241/lab-1-trenthiner$ vim src/main/java/lab1/Hello.java
[?1049h[?1h=[2;1H▽[6n[2;1H  [1;1H]11;?[1;24r[?12;25h[?12l[?25h[27m[23m[m[H[2J[?25l[24;1H"src/main/java/lab1/Hello.java" 7L, 131C[>c[27m[23m[m[H[2J[1;1H[38;5;81mpackage[m lab1;

[38;5;121mpublic[m [38;5;121mclass[m Hello{
    [38;5;121mpublic[m [38;5;121mstatic[m [38;5;121mvoid[m main(String[] args){[5;9HSystem.out.println([95m"Hello World!"[m);
    }
}
[94m~                                                                                                            [9;1H~                                                                                                            [10;1H~                                                                                                            [11;1H~                                                                                                            [12;1H~                                                                                                            [13;1H~                                                                                                            [14;1H~                                                                                                            [15;1H~                                                                                                            [16;1H~                                                                                                            [17;1H~                                                                                                            [18;1H~                                                                                                            [19;1H~                                                                                                            [20;1H~                                                                                                            [21;1H~                                                                                                            [22;1H~                                                                                                            [23;1H~                                                                                                            [m[24;92H1,1[11CAll"src/main/java/lab1/Hello.java" 7L, 131C[51C   [11C   [1;1H]2;Hello.java (~/csci241/lab-1-trenthiner/src/main/java/lab1) - VIM]1;Hello.java[?12l[?25hP+q436f\P+q6b75\P+q6b64\P+q6b72\P+q6b6c\P+q2332\P+q2334\P+q2569\P+q2a37\P+q6b31\[?25l[24;1H[1m-- INSERT --[m[24;13H[K[24;92H1,2[11CAll[1;2H[?12l[?25h[?25lprackage lab1;[24;94H3]2;Hello.java + (~/csci241/lab-1-trenthiner/src/main/java/lab1) - VIM]1;Hello.java[1;3H[?12l[?25h[?25l[38;5;81mpackage[m lab1;[1;14H[K[24;94H2[1;2H[?12l[?25h[?25l[24;92H2,1[2;1H[?12l[?25h[?25l[24;92H3,2[3;2H[?12l[?25h[?25l[24;94H3[3;3H[?12l[?25h[?25l[24;92H4[4;3H[?12l[?25h[?25l[24;92H5[5;3H[?12l[?25h[?25l[24;94H4[5;4H[?12l[?25h[?25l[24;94H5[5;5H[?12l[?25h[?25l[24;94H6[5;6H[?12l[?25h[?25l[24;94H7[5;7H[?12l[?25h[?25l[24;94H8[5;8H[?12l[?25h[?25l[24;94H9[5;9H[?12l[?25h[?25l[24;94H10[5;10H[?12l[?25h[?25l[24;95H1[5;11H[?12l[?25h[?25l[24;95H2[5;12H[?12l[?25h[?25l[24;95H3[5;13H[?12l[?25h[?25l[24;95H4[5;14H[?12l[?25h[?25l[24;95H5[5;15H[?12l[?25h[?25l[24;95H6[5;16H[?12l[?25h[?25l[24;95H7[5;17H[?12l[?25h[?25l[24;95H8[5;18H[?12l[?25h[?25l[24;95H9[5;19H[?12l[?25h[?25l[24;94H20[5;20H[?12l[?25h[?25l[24;95H1[5;21H[?12l[?25h[?25l[24;95H2[5;22H[?12l[?25h[?25l[24;95H3[5;23H[?12l[?25h[?25l[24;95H4[5;24H[?12l[?25h[?25l[24;95H5[5;25H[?12l[?25h[?25l[24;95H6[5;26H[?12l[?25h[?25ln[46m([14C)[m[24;95H7[5;27H[?12l[?25h[?25l[24;95H8[5;28H[?12l[?25h[?25l([14C)[24;95H9[5;29H[?12l[?25h[?25l[24;94H30[5;30H[?12l[?25h[?25l[24;95H1[5;31H[?12l[?25h[?25l[24;95H2[5;32H[?12l[?25h[?25l[24;95H3[5;33H[?12l[?25h[?25l[24;95H4[5;34H[?12l[?25h[?25l[24;95H5[5;35H[?12l[?25h[?25l[24;95H6[5;36H[?12l[?25h[?25l[24;95H7[5;37H[?12l[?25h[?25l[24;95H8[5;38H[?12l[?25h[?25l[24;95H9[5;39H[?12l[?25h[?25l[24;94H40[5;40H[?12l[?25h[?25l[24;95H1[5;41H[?12l[?25h[?25l[24;95H0[5;40H[?12l[?25h[?25l[95m"[m);[5;43H[K[5;40H[?12l[?25h[?25l[24;94H39[5;39H[?12l[?25h[?25l[95m"[m);[5;42H[K[5;39H[?12l[?25h[?25l[24;95H8[5;38H[?12l[?25h[?25l[95m"[m);[5;41H[K[5;38H[?12l[?25h[?25l[24;95H7[5;37H[?12l[?25h[?25l[95m"[m);[5;40H[K[5;37H[?12l[?25h[?25l[24;95H6[5;36H[?12l[?25h[?25l[95m"[m);[5;39H[K[5;36H[?12l[?25h[?25l[24;95H5[5;35H[?12l[?25h[?25l[95m"[m);[5;38H[K[5;35H[?12l[?25h[?25l[24;95H4[5;34H[?12l[?25h[?25l[24;95H5[5;35H[?12l[?25h[?25l[95m-"[m);[24;95H6[5;36H[?12l[?25h[?25l[95m-"[m);[24;95H7[5;37H[?12l[?25h[?25l[95ma"[m);[24;95H8[5;38H[?12l[?25h[?25l[95mr"[m);[24;95H9[5;39H[?12l[?25h[?25l[95mg"[m);[24;94H40[5;40H[?12l[?25h[?25l[95ms"[m);[24;95H1[5;41H[?12l[?25h[24;1H[K[5;40H[?25l[24;92H5,40[10CAll[5;40H[?12l[?25h[?25l[24;92H[K[24;1H:[?12l[?25hw[?25l[?12l[?25hq[?25l[?12l[?25h[?25l"src/main/java/lab1/Hello.java" 7L, 131C written]2;Terminal]1;Terminal
[?1l>[?12l[?25h[?1049lhinert@CF165-18:~/csci241/lab-1-trenthiner$ grade rune[K --args"73"
No command 'grade' found, did you mean:
 Command 'grace' from package 'grace' (universe)
 Command 'gradle' from package 'gradle' (universe)
 Command 'glade' from package 'glade' (universe)
 Command 'grads' from package 'grads' (universe)
grade: command not found
hinert@CF165-18:~/csci241/lab-1-trenthiner$ grade run --args"73"[1@l
[0m
[31mFAILURE: [39m[31mBuild failed with an exception.[39m

* What went wrong:
Problem configuring task :run from command line.
[33m> [39mUnknown command-line option '--args73'.

* Try:
Run [1mgradle help --task :run[m to get task usage details. Run with [1m--stacktrace[m option to get the stack trace. Run with [1m--info[m or [1m--debug[m option to get more log output. Run with [1m--scan[m to get full insights.

* Get more help at [1mhttps://help.gradle.org[m

[31;1mBUILD FAILED[0;39m in 0s

[1A[1m<[0;32;1;0;39;1m-------------> 0% WAITING[m[26D[1B[1A[1m<[0;32;1;0;39;1m-------------> 0% WAITING[m[26D[1B[1A[2K[0mhinert@CF165-18:~/csci241/lab-1-trenthiner$ gradle run --args"73"[C[C[C[C="73"
[0m

[2A[1m<[0;32;1;0;39;1m-------------> 0% EXECUTING [0s][m[33D[1B[1m> :compileJava[m[14D[1B[2A[1m<[0;32;1m=========[0;39;1m----> 75% EXECUTING [0s][m[34D[1B[1m> :run[m[0K[6D[1B[2A[0K
[1m> Task :run[m
Hello --args

[32;1mBUILD SUCCESSFUL[0;39m in 0s
2 actionable tasks: 2 executed
[0K
[0K
[2A[1m<[0;32;1;0;39;1m-------------> 0% WAITING[m[26D[1B[1m> :run[m[6D[1B[2A[2K[1B[2K[1A[0mhinert@CF165-18:~/csci241/lab-1-trenthiner$ gradle run --args="73"[1@$[1@ 
$: command not found
hinert@CF165-18:~/csci241/lab-1-trenthiner$ $ gradle run --args="73"[2P[C[C[C[C[C[C[C[C[C[C[C[C[C[C[C[C[C[C[C[C[C[C
[0m
[1A
[1m> Task :run[m
Hello --args

[32;1mBUILD SUCCESSFUL[0;39m in 0s
2 actionable tasks: 1 executed, 1 up-to-date

[1A[1m<[0;32;1;0;39;1m-------------> 0% WAITING[m[26D[1B[1A[1m<[0;32;1;0;39;1m-------------> 0% WAITING[m[26D[1B[1A[2K[0mhinert@CF165-18:~/csci241/lab-1-trenthiner$ gradle run --args="73"[2@$ [C[C[C[C[C[C[C[C[C[C[C[C[C[C[C[C[C[C[C[C[C[C[2P[C[C[C[C[C[C[C[C[C[C[C[C[C[C[C[C[C[C[C[C[C[C[1P"73"[1P[C[C[C[C[C[C[C[C[C[C[C[C[C[C[C[Cvim src/main/java/lab1/Hello.java
[?1049h[?1h=[2;1H▽[6n[2;1H  [1;1H]11;?[1;24r[?12;25h[?12l[?25h[27m[23m[m[H[2J[?25l[24;1H"src/main/java/lab1/Hello.java" 7L, 131C[>c[1;1H[35mpackage[m lab1;

[32mpublic[m [32mclass[m Hello{
    [32mpublic[m [32mstatic[m [32mvoid[m main(String[] args){[5;9HSystem.out.println([31m"Hello --args"[m);
    }
}
[94m~                                                                                                            [9;1H~                                                                                                            [10;1H~                                                                                                            [11;1H~                                                                                                            [12;1H~                                                                                                            [13;1H~                                                                                                            [14;1H~                                                                                                            [15;1H~                                                                                                            [16;1H~                                                                                                            [17;1H~                                                                                                            [18;1H~                                                                                                            [19;1H~                                                                                                            [20;1H~                                                                                                            [21;1H~                                                                                                            [22;1H~                                                                                                            [23;1H~                                                                                                            [m[24;92H1,1[11CAll]2;Hello.java (~/csci241/lab-1-trenthiner/src/main/java/lab1) - VIM]1;Hello.java[1;1H[?12l[?25h[27m[23m[m[H[2J[?25l[1;1H[38;5;81mpackage[m lab1;

[38;5;121mpublic[m [38;5;121mclass[m Hello{
    [38;5;121mpublic[m [38;5;121mstatic[m [38;5;121mvoid[m main(String[] args){[5;9HSystem.out.println([95m"Hello --args"[m);
    }
}
[94m~                                                                                                            [9;1H~                                                                                                            [10;1H~                                                                                                            [11;1H~                                                                                                            [12;1H~                                                                                                            [13;1H~                                                                                                            [14;1H~                                                                                                            [15;1H~                                                                                                            [16;1H~                                                                                                            [17;1H~                                                                                                            [18;1H~                                                                                                            [19;1H~                                                                                                            [20;1H~                                                                                                            [21;1H~                                                                                                            [22;1H~                                                                                                            [23;1H~                                                                                                            [m[24;92H1,1[11CAll"src/main/java/lab1/Hello.java" 7L, 131C[1;1HP+q436f\P+q6b75\P+q6b64\P+q6b72\P+q6b6c\P+q2332\P+q2334\P+q2569\P+q2a37\P+q6b31\[?12l[?25h[?25l[24;92H2,0-1[2;1H[?12l[?25h[?25l[24;92H3,1  [3;1H[?12l[?25h[?25l[24;92H4[4;1H[?12l[?25h[?25l[24;92H5[5;1H[?12l[?25h[?25l[24;94H2[5;2H[?12l[?25h[?25l[24;94H3[5;3H[?12l[?25h[?25l[24;94H4[5;4H[?12l[?25h[?25l[24;94H5[5;5H[?12l[?25h[?25l[24;94H6[5;6H[?12l[?25h[?25l[24;94H7[5;7H[?12l[?25h[?25l[24;94H8[5;8H[?12l[?25h[?25l[24;94H9[5;9H[?12l[?25h[?25l[24;94H10[5;10H[?12l[?25h[?25l[24;95H1[5;11H[?12l[?25h[?25l[24;95H2[5;12H[?12l[?25h[?25l[24;95H3[5;13H[?12l[?25h[?25l[24;95H4[5;14H[?12l[?25h[?25l[24;95H5[5;15H[?12l[?25h[?25l[24;95H6[5;16H[?12l[?25h[?25l[24;95H7[5;17H[?12l[?25h[?25l[24;95H8[5;18H[?12l[?25h[?25l[24;95H9[5;19H[?12l[?25h[?25l[24;94H20[5;20H[?12l[?25h[?25l[24;95H1[5;21H[?12l[?25h[?25l[24;95H2[5;22H[?12l[?25h[?25l[24;95H3[5;23H[?12l[?25h[?25l[24;95H4[5;24H[?12l[?25h[?25l[24;95H5[5;25H[?12l[?25h[?25l[24;95H6[5;26H[?12l[?25h[?25ln[46m([14C)[m[24;95H7[5;27H[?12l[?25h[?25l([14C)[24;95H8[5;28H[?12l[?25h[?25l[24;95H9[5;29H[?12l[?25h[?25l[24;94H30[5;30H[?12l[?25h[?25l[24;95H1[5;31H[?12l[?25h[?25l[24;95H2[5;32H[?12l[?25h[?25l[24;95H3[5;33H[?12l[?25h[?25l[24;95H4[5;34H[?12l[?25h[?25l[4;43H[46m{[6;5H}[m[24;92H6,5 [6;5H[?12l[?25h[?25l[3;19H[46m{[m[4;43H{[6;5H}
[46m}[m[24;92H7,1[7;1H[?12l[?25h[?25l[3;19H{[4;43H[46m{[6;5H}[m
}[24;92H6,5[6;5H[?12l[?25h[?25l[4;43H{[6;5H}[24;94H4[6;4H[?12l[?25h[?25l[24;94H3[6;3H[?12l[?25h[?25l[24;92H5[5;3H[?12l[?25h[?25l[24;94H2[5;2H[?12l[?25h[?25l[24;94H3[5;3H[?12l[?25h[?25l[24;94H4[5;4H[?12l[?25h[?25l[24;94H5[5;5H[?12l[?25h[?25l[24;94H6[5;6H[?12l[?25h[?25l[24;94H7[5;7H[?12l[?25h[?25l[24;94H8[5;8H[?12l[?25h[?25l[24;94H9[5;9H[?12l[?25h[?25l[24;94H10[5;10H[?12l[?25h[?25l[24;95H1[5;11H[?12l[?25h[?25l[24;95H2[5;12H[?12l[?25h[?25l[24;95H3[5;13H[?12l[?25h[?25l[24;95H4[5;14H[?12l[?25h[?25l[24;95H5[5;15H[?12l[?25h[?25l[24;95H6[5;16H[?12l[?25h[?25l[24;95H7[5;17H[?12l[?25h[?25l[24;95H8[5;18H[?12l[?25h[?25l[24;95H9[5;19H[?12l[?25h[?25l[24;94H20[5;20H[?12l[?25h[?25l[24;95H1[5;21H[?12l[?25h[?25l[24;95H2[5;22H[?12l[?25h[?25l[24;95H3[5;23H[?12l[?25h[?25l[24;95H4[5;24H[?12l[?25h[?25l[24;95H5[5;25H[?12l[?25h[?25l[24;95H6[5;26H[?12l[?25h[?25ln[46m([14C)[m[24;95H7[5;27H[?12l[?25h[?25l([14C)[24;95H8[5;28H[?12l[?25h[?25l[24;95H9[5;29H[?12l[?25h[?25l[24;94H30[5;30H[?12l[?25h[?25l[24;95H1[5;31H[?12l[?25h[?25l[24;95H2[5;32H[?12l[?25h[?25l[24;95H3[5;33H[?12l[?25h[?25l[24;95H4[5;34H[?12l[?25h[?25l[24;95H5[5;35H[?12l[?25h[?25l[24;95H6[5;36H[?12l[?25h[?25l[24;95H7[5;37H[?12l[?25h[?25l[24;95H6[5;36H[?12l[?25h[?25l[95margs"[m);[5;43H[K]2;Hello.java + (~/csci241/lab-1-trenthiner/src/main/java/lab1) - VIM]1;Hello.java[5;36H[?12l[?25h[?25l[24;95H5[5;35H[?12l[?25h[?25l[95margs"[m);[5;42H[K[5;35H[?12l[?25h[?25l[24;1H[K[24;1H:[?12l[?25hw[?25l[?12l[?25hq[?25l[?12l[?25h[?25l"src/main/java/lab1/Hello.java" 7L, 129C written]2;Terminal]1;Terminal
[?1l>[?12l[?25h[?1049lhinert@CF165-18:~/csci241/lab-1-trenthiner$ vim src/main/java/lab1/Hello.java[11Pgradle run --args="73"
[0m

[2A[1m<[0;32;1;0;39;1m-------------> 0% EXECUTING [0s][m[33D[1B[1m> :compileJava[m[14D[1B[2A[0K
[1m> Task :run[m[0K
Hello args

[32;1mBUILD SUCCESSFUL[0;39m in 0s
2 actionable tasks: 2 executed
[0K
[0K
[2A[1m<[0;32;1;0;39;1m-------------> 0% WAITING[m[26D[1B[1m> :compileJava[m[14D[1B[2A[2K[1B[2K[1A[0mhinert@CF165-18:~/csci241/lab-1-trenthiner$ gradle run --args="73"vim src/main/java/lab1/Hello.java
[?1049h[?1h=[2;1H▽[6n[2;1H  [1;1H]11;?[1;24r[?12;25h[?12l[?25h[27m[23m[m[H[2J[?25l[24;1H"src/main/java/lab1/Hello.java" 7L, 129C[>c[1;1H[35mpackage[m lab1;

[32mpublic[m [32mclass[m Hello{
    [32mpublic[m [32mstatic[m [32mvoid[m main(String[] args){[5;9HSystem.out.println([31m"Hello args"[m);
    }
}
[94m~                                                                                                            [9;1H~                                                                                                            [10;1H~                                                                                                            [11;1H~                                                                                                            [12;1H~                                                                                                            [13;1H~                                                                                                            [14;1H~                                                                                                            [15;1H~                                                                                                            [16;1H~                                                                                                            [17;1H~                                                                                                            [18;1H~                                                                                                            [19;1H~                                                                                                            [20;1H~                                                                                                            [21;1H~                                                                                                            [22;1H~                                                                                                            [23;1H~                                                                                                            [m[24;92H1,1[11CAll]2;Hello.java (~/csci241/lab-1-trenthiner/src/main/java/lab1) - VIM]1;Hello.java[1;1H[?12l[?25h[27m[23m[m[H[2J[?25l[1;1H[38;5;81mpackage[m lab1;

[38;5;121mpublic[m [38;5;121mclass[m Hello{
    [38;5;121mpublic[m [38;5;121mstatic[m [38;5;121mvoid[m main(String[] args){[5;9HSystem.out.println([95m"Hello args"[m);
    }
}
[94m~                                                                                                            [9;1H~                                                                                                            [10;1H~                                                                                                            [11;1H~                                                                                                            [12;1H~                                                                                                            [13;1H~                                                                                                            [14;1H~                                                                                                            [15;1H~                                                                                                            [16;1H~                                                                                                            [17;1H~                                                                                                            [18;1H~                                                                                                            [19;1H~                                                                                                            [20;1H~                                                                                                            [21;1H~                                                                                                            [22;1H~                                                                                                            [23;1H~                                                                                                            [m[24;92H1,1[11CAll"src/main/java/lab1/Hello.java" 7L, 129C[1;1HP+q436f\P+q6b75\P+q6b64\P+q6b72\P+q6b6c\P+q2332\P+q2334\P+q2569\P+q2a37\P+q6b31\[?12l[?25h[?25l[24;94H2[1;2H[?12l[?25h[?25l[24;94H3[1;3H[?12l[?25h[?25l[24;94H4[1;4H[?12l[?25h[?25l[24;94H5[1;5H[?12l[?25h[?25l[24;94H6[1;6H[?12l[?25h[?25l[24;94H7[1;7H[?12l[?25h[?25l[24;94H8[1;8H[?12l[?25h[?25l[24;94H9[1;9H[?12l[?25h[?25l[24;94H10[1;10H[?12l[?25h[?25l[24;92H2,0-1[2;1H[?12l[?25h[?25l[24;92H3,10 [3;10H[?12l[?25h[?25l[24;92H4[4;10H[?12l[?25h[?25l[24;92H5[5;10H[?12l[?25h[?25l[4;43H[46m{[6;5H}[m[24;92H6,5 [6;5H[?12l[?25h[?25l[4;43H{[6;5H}[24;94H4[6;4H[?12l[?25h[?25l[24;92H5[5;4H[?12l[?25h[?25l[24;94H5[5;5H[?12l[?25h[?25l[24;94H6[5;6H[?12l[?25h[?25l[24;94H7[5;7H[?12l[?25h[?25l[24;94H8[5;8H[?12l[?25h[?25l[24;94H9[5;9H[?12l[?25h[?25l[24;94H10[5;10H[?12l[?25h[?25l[24;95H1[5;11H[?12l[?25h[?25l[24;95H2[5;12H[?12l[?25h[?25l[24;95H3[5;13H[?12l[?25h[?25l[24;95H4[5;14H[?12l[?25h[?25l[24;95H5[5;15H[?12l[?25h[?25l[24;95H6[5;16H[?12l[?25h[?25l[24;95H7[5;17H[?12l[?25h[?25l[24;95H8[5;18H[?12l[?25h[?25l[24;95H9[5;19H[?12l[?25h[?25l[24;94H20[5;20H[?12l[?25h[?25l[24;95H1[5;21H[?12l[?25h[?25l[24;95H2[5;22H[?12l[?25h[?25l[24;95H3[5;23H[?12l[?25h[?25l[24;95H4[5;24H[?12l[?25h[?25l[24;95H5[5;25H[?12l[?25h[?25l[24;95H6[5;26H[?12l[?25h[?25ln[46m([12C)[m[24;95H7[5;27H[?12l[?25h[?25l([12C)[24;95H8[5;28H[?12l[?25h[?25l[24;95H9[5;29H[?12l[?25h[?25l[24;94H30[5;30H[?12l[?25h[?25l[24;95H1[5;31H[?12l[?25h[?25l[24;95H2[5;32H[?12l[?25h[?25l[24;95H3[5;33H[?12l[?25h[?25l[24;95H4[5;34H[?12l[?25h[?25l[24;95H5[5;35H[?12l[?25h[?25l[24;95H6[5;36H[?12l[?25h[?25l[24;95H7[5;37H[?12l[?25h[?25l[24;95H8[5;38H[?12l[?25h[?25l[24;95H7[5;37H[?12l[?25h[?25l[24;95H6[5;36H[?12l[?25h[?25l[24;95H5[5;35H[?12l[?25h[?25l[24;95H6[5;36H[?12l[?25h[?25l[24;95H7[5;37H[?12l[?25h[?25l[24;95H8[5;38H[?12l[?25h[?25l[24;95H9[5;39H[?12l[?25h[?25l[24;95H8[5;38H[?12l[?25h[?25l[24;95H7[5;37H[?12l[?25h[?25l[24;95H6[5;36H[?12l[?25h[?25l[24;95H5[5;35H[?12l[?25h[?25l[24;95H4[5;34H[?12l[?25h[?25l[24;95H5[5;35H[?12l[?25h[?25l[24;95H6[5;36H[?12l[?25h[?25l[24;95H7[5;37H[?12l[?25h[?25l[24;95H8[5;38H[?12l[?25h[?25l[95m"[m);[5;41H[K]2;Hello.java + (~/csci241/lab-1-trenthiner/src/main/java/lab1) - VIM]1;Hello.java[5;38H[?12l[?25h[?25l[24;95H7[5;37H[?12l[?25h[?25l[95m"[m);[5;40H[K[5;37H[?12l[?25h[?25l[24;95H6[5;36H[?12l[?25h[?25l[95m"[m);[5;39H[K[5;36H[?12l[?25h[?25l[24;95H5[5;35H[?12l[?25h[?25l[95m"[m);[5;38H[K[5;35H[?12l[?25h[?25l[5;27H[46m([8C)[m[24;95H6[5;36H[?12l[?25h[?25l[5;27H([8C)[24;95H7[5;37H[?12l[?25h[?25l[4;43H[46m{[6;5H}[m[24;92H6,5 [6;5H[?12l[?25h[?25l[3;19H[46m{[m[4;43H{[6;5H}
[46m}[m[24;92H7,1[7;1H[?12l[?25h[?25l[3;19H{[4;43H[46m{[6;5H}[m
}[24;92H6,5[6;5H[?12l[?25h[?25l[4;43H{[6;5H}[24;94H4[6;4H[?12l[?25h[?25l[24;94H3[6;3H[?12l[?25h[?25l[24;94H2[6;2H[?12l[?25h[?25l[24;92H5[5;2H[?12l[?25h[?25l[24;94H3[5;3H[?12l[?25h[?25l[24;94H4[5;4H[?12l[?25h[?25l[24;94H5[5;5H[?12l[?25h[?25l[24;94H6[5;6H[?12l[?25h[?25l[24;94H7[5;7H[?12l[?25h[?25l[24;94H8[5;8H[?12l[?25h[?25l[24;94H9[5;9H[?12l[?25h[?25l[24;94H10[5;10H[?12l[?25h[?25l[24;95H1[5;11H[?12l[?25h[?25l[24;95H2[5;12H[?12l[?25h[?25l[24;95H3[5;13H[?12l[?25h[?25l[24;95H4[5;14H[?12l[?25h[?25l[24;95H5[5;15H[?12l[?25h[?25l[24;95H6[5;16H[?12l[?25h[?25l[24;95H7[5;17H[?12l[?25h[?25l[24;95H8[5;18H[?12l[?25h[?25l[24;95H9[5;19H[?12l[?25h[?25l[24;94H20[5;20H[?12l[?25h[?25l[24;95H1[5;21H[?12l[?25h[?25l[24;95H2[5;22H[?12l[?25h[?25l[24;95H3[5;23H[?12l[?25h[?25l[24;95H4[5;24H[?12l[?25h[?25l[24;95H5[5;25H[?12l[?25h[?25l[24;95H6[5;26H[?12l[?25h[?25ln[46m([8C)[m[24;95H7[5;27H[?12l[?25h[?25l([8C)[24;95H8[5;28H[?12l[?25h[?25l[24;95H9[5;29H[?12l[?25h[?25l[24;94H30[5;30H[?12l[?25h[?25l[24;95H1[5;31H[?12l[?25h[?25l[24;95H2[5;32H[?12l[?25h[?25l[24;95H3[5;33H[?12l[?25h[?25l[24;95H4[5;34H[?12l[?25h[?25l[24;95H5[5;35H[?12l[?25h[?25l[5;27H[46m([8C)[m[24;95H6[5;36H[?12l[?25h[?25l[4;43H[46m{[m[5;27H([8C)
    [46m}[m[24;92H6,5 [6;5H[?12l[?25h[?25l[4;43H{[6;5H}[24;94H4[6;4H[?12l[?25h[?25l[24;94H3[6;3H[?12l[?25h[?25l[24;94H2[6;2H[?12l[?25h[?25l[24;94H1[6;1H[?12l[?25h[?25l[24;92H5[5;1H[?12l[?25h[?25l[24;94H2[5;2H[?12l[?25h[?25l[24;94H3[5;3H[?12l[?25h[?25l[24;94H4[5;4H[?12l[?25h[?25l[24;94H5[5;5H[?12l[?25h[?25l[24;94H6[5;6H[?12l[?25h[?25l[24;94H7[5;7H[?12l[?25h[?25l[24;94H8[5;8H[?12l[?25h[?25l[24;94H9[5;9H[?12l[?25h[?25l[24;94H10[5;10H[?12l[?25h[?25l[24;95H1[5;11H[?12l[?25h[?25l[24;95H2[5;12H[?12l[?25h[?25l[24;95H3[5;13H[?12l[?25h[?25l[24;95H4[5;14H[?12l[?25h[?25l[24;95H5[5;15H[?12l[?25h[?25l[24;95H6[5;16H[?12l[?25h[?25l[24;95H7[5;17H[?12l[?25h[?25l[24;95H8[5;18H[?12l[?25h[?25l[24;95H9[5;19H[?12l[?25h[?25l[24;94H20[5;20H[?12l[?25h[?25l[24;95H1[5;21H[?12l[?25h[?25l[24;95H2[5;22H[?12l[?25h[?25l[24;95H3[5;23H[?12l[?25h[?25l[24;95H4[5;24H[?12l[?25h[?25l[24;95H5[5;25H[?12l[?25h[?25l[24;95H6[5;26H[?12l[?25h[?25ln[46m([8C)[m[24;95H7[5;27H[?12l[?25h[?25l([8C)[24;95H8[5;28H[?12l[?25h[?25l[24;95H9[5;29H[?12l[?25h[?25l[24;94H30[5;30H[?12l[?25h[?25l[24;95H1[5;31H[?12l[?25h[?25l[24;95H2[5;32H[?12l[?25h[?25l[24;95H3[5;33H[?12l[?25h[?25l[24;95H4[5;34H[?12l[?25h[?25l[24;95H5[5;35H[?12l[?25h[?25l[5;27H[46m([8C)[m[24;95H6[5;36H[?12l[?25h[?25l[5;27H([8C)[24;95H7[5;37H[?12l[?25h[?25l[24;1H[1m-- INSERT --[m[24;13H[K[24;92H5,38[10CAll[5;38H[?12l[?25h[?25l[5;27H[46m([8C)[m[24;95H7[5;37H[?12l[?25h[?25l[24;95H6[5;36H[?12l[?25h[?25l[46m [m); [46m)[m[24;95H7[5;37H[?12l[?25h[?25l[5;27H([9C)[24;95H6[5;36H[?12l[?25h[?25la );[24;95H7[5;37H[?12l[?25h[?25lr );[24;95H8[5;38H[?12l[?25h[?25lg );[24;95H9[5;39H[?12l[?25h[?25ls );[24;94H40[5;40H[?12l[?25h[?25l[24;94H39[5;39H[?12l[?25h[?25l[24;95H8[5;38H[?12l[?25h[?25l[24;95H7[5;37H[?12l[?25h[?25l[24;95H6[5;36H[?12l[?25h[?25l args );[24;95H7[5;37H[?12l[?25h[?25l[24;95H6[5;36H[?12l[?25h[?25l+ args );[24;95H7[5;37H[?12l[?25h[?25l[24;95H6[5;36H[?12l[?25h[?25l + args );[24;95H7[5;37H[?12l[?25h[?25l[24;95H8[5;38H[?12l[?25h[?25l[24;95H9[5;39H[?12l[?25h[?25l[24;94H40[5;40H[?12l[?25h[?25l[24;95H1[5;41H[?12l[?25h[?25l[24;95H2[5;42H[?12l[?25h[?25l[24;95H3[5;43H[?12l[?25h[?25l);[5;45H[K[5;27H[46m([15C)[?12l[?25h[m[24;1H[K[5;42H[?25l[5;27H([15C)[24;92H5,42[10CAll[5;42H[?12l[?25h[?25l[24;92H[K[24;1H:[?12l[?25hw[?25l[?12l[?25hq[?25l[?12l[?25h[?25l"src/main/java/lab1/Hello.java" 7L, 132C written]2;Terminal]1;Terminal
[?1l>[?12l[?25h[?1049lhinert@CF165-18:~/csci241/lab-1-trenthiner$ vim src/main/java/lab1/Hello.java[11Pgradle run --args="73"
[0m

[2A[1m<[0;32;1m=========[0;39;1m----> 75% EXECUTING [0s][m[34D[1B[1m> :run[m[6D[1B[2A[0K
[1m> Task :run[m
Hello [Ljava.lang.String;@4aa298b7

[32;1mBUILD SUCCESSFUL[0;39m in 0s
2 actionable tasks: 2 executed
[0K
[0K
[2A[1m<[0;32;1;0;39;1m-------------> 0% WAITING[m[26D[1B[1m> :run[m[6D[1B[2A[2K[1B[2K[1A[0mhinert@CF165-18:~/csci241/lab-1-trenthiner$ gradle run --args="73"vim src/main/java/lab1/Hello.java
[?1049h[?1h=[2;1H▽[6n[2;1H  [1;1H]11;?[1;24r[?12;25h[?12l[?25h[27m[23m[m[H[2J[?25l[24;1H"src/main/java/lab1/Hello.java" 7L, 132C[>c[1;1H[35mpackage[m lab1;

[32mpublic[m [32mclass[m Hello{
    [32mpublic[m [32mstatic[m [32mvoid[m main(String[] args){[5;9HSystem.out.println([31m"Hello "[m + args);
    }
}
[94m~                                                                                                            [9;1H~                                                                                                            [10;1H~                                                                                                            [11;1H~                                                                                                            [12;1H~                                                                                                            [13;1H~                                                                                                            [14;1H~                                                                                                            [15;1H~                                                                                                            [16;1H~                                                                                                            [17;1H~                                                                                                            [18;1H~                                                                                                            [19;1H~                                                                                                            [20;1H~                                                                                                            [21;1H~                                                                                                            [22;1H~                                                                                                            [23;1H~                                                                                                            [m[24;92H1,1[11CAll]2;Hello.java (~/csci241/lab-1-trenthiner/src/main/java/lab1) - VIM]1;Hello.java[1;1H[?12l[?25h[27m[23m[m[H[2J[?25l[1;1H[38;5;81mpackage[m lab1;

[38;5;121mpublic[m [38;5;121mclass[m Hello{
    [38;5;121mpublic[m [38;5;121mstatic[m [38;5;121mvoid[m main(String[] args){[5;9HSystem.out.println([95m"Hello "[m + args);
    }
}
[94m~                                                                                                            [9;1H~                                                                                                            [10;1H~                                                                                                            [11;1H~                                                                                                            [12;1H~                                                                                                            [13;1H~                                                                                                            [14;1H~                                                                                                            [15;1H~                                                                                                            [16;1H~                                                                                                            [17;1H~                                                                                                            [18;1H~                                                                                                            [19;1H~                                                                                                            [20;1H~                                                                                                            [21;1H~                                                                                                            [22;1H~                                                                                                            [23;1H~                                                                                                            [m[24;92H1,1[11CAll"src/main/java/lab1/Hello.java" 7L, 132C[1;1HP+q436f\P+q6b75\P+q6b64\P+q6b72\P+q6b6c\P+q2332\P+q2334\P+q2569\P+q2a37\P+q6b31\[?12l[?25h[?25l[24;94H2[1;2H[?12l[?25h[?25l[24;92H2,0-1[2;1H[?12l[?25h[?25l[24;92H3,2  [3;2H[?12l[?25h[?25l[24;92H4[4;2H[?12l[?25h[?25l[24;92H5[5;2H[?12l[?25h[?25l[24;94H3[5;3H[?12l[?25h[?25l[24;94H4[5;4H[?12l[?25h[?25l[24;94H5[5;5H[?12l[?25h[?25l[24;94H6[5;6H[?12l[?25h[?25l[24;94H7[5;7H[?12l[?25h[?25l[24;94H8[5;8H[?12l[?25h[?25l[24;94H9[5;9H[?12l[?25h[?25l[24;94H10[5;10H[?12l[?25h[?25l[24;95H1[5;11H[?12l[?25h[?25l[24;95H2[5;12H[?12l[?25h[?25l[24;95H3[5;13H[?12l[?25h[?25l[24;95H4[5;14H[?12l[?25h[?25l[24;95H5[5;15H[?12l[?25h[?25l[24;95H6[5;16H[?12l[?25h[?25l[24;95H7[5;17H[?12l[?25h[?25l[24;95H8[5;18H[?12l[?25h[?25l[24;95H9[5;19H[?12l[?25h[?25l[24;94H20[5;20H[?12l[?25h[?25l[24;95H1[5;21H[?12l[?25h[?25l[24;95H2[5;22H[?12l[?25h[?25l[24;95H3[5;23H[?12l[?25h[?25l[24;95H4[5;24H[?12l[?25h[?25l[24;95H5[5;25H[?12l[?25h[?25l[24;95H6[5;26H[?12l[?25h[?25ln[46m([15C)[m[24;95H7[5;27H[?12l[?25h[?25l([15C)[24;95H8[5;28H[?12l[?25h[?25l[24;95H9[5;29H[?12l[?25h[?25l[24;94H30[5;30H[?12l[?25h[?25l[24;95H1[5;31H[?12l[?25h[?25l[24;95H2[5;32H[?12l[?25h[?25l[24;95H3[5;33H[?12l[?25h[?25l[24;95H4[5;34H[?12l[?25h[?25l[24;95H5[5;35H[?12l[?25h[?25l[24;95H6[5;36H[?12l[?25h[?25l[24;95H7[5;37H[?12l[?25h[?25l[24;95H8[5;38H[?12l[?25h[?25l[24;95H9[5;39H[?12l[?25h[?25l[24;95H8[5;38H[?12l[?25h[?25l[24;1H[1m-- INSERT --[m[24;13H[K[24;92H5,38[10CAll[5;38H[?12l[?25h[?25l- args);[24;95H9]2;Hello.java + (~/csci241/lab-1-trenthiner/src/main/java/lab1) - VIM]1;Hello.java[5;39H[?12l[?25h[?25l- args);[24;94H40[5;40H[?12l[?25h[?25l[24;94H39[5;39H[?12l[?25h[?25l[24;95H8[5;38H[?12l[?25h[?25l -- args);[24;95H9[5;39H[?12l[?25h[?25l[24;94H40[5;40H[?12l[?25h[?25l[24;95H1[5;41H[?12l[?25h[?25largs);[5;47H[K[5;41H[?12l[?25h[24;1H[K[5;40H[?25l[24;92H5,40[10CAll[5;40H[?12l[?25h[?25l[24;92H[K[24;1H:[?12l[?25hw[?25l[?12l[?25hq[?25l[?12l[?25h[?25l"src/main/java/lab1/Hello.java" 7L, 134C written]2;Terminal]1;Terminal
[?1l>[?12l[?25h[?1049lhinert@CF165-18:~/csci241/lab-1-trenthiner$ vim src/main/java/lab1/Hello.java[11Pgradle run --args="73"
[0m
[31;1m> Task :compileJava[0;39m[31m FAILED[39m
/home/hinert/csci241/lab-1-trenthiner/src/main/java/lab1/Hello.java:5: error: bad operand type String[] for unary operator '--'
        System.out.println("Hello " + --args);
                                      ^
1 error

[31mFAILURE: [39m[31mBuild failed with an exception.[39m

* What went wrong:
Execution failed for task ':compileJava'.
[33m> [39mCompilation failed; see the compiler error output for details.

* Try:
Run with [1m--stacktrace[m option to get the stack trace. Run with [1m--info[m or [1m--debug[m option to get more log output. Run with [1m--scan[m to get full insights.

* Get more help at [1mhttps://help.gradle.org[m

[31;1mBUILD FAILED[0;39m in 0s
1 actionable task: 1 executed

[1A[1m<[0;32;1;0;39;1m-------------> 0% WAITING[m[26D[1B[1A[1m<[0;32;1;0;39;1m-------------> 0% WAITING[m[26D[1B[1A[2K[0mhinert@CF165-18:~/csci241/lab-1-trenthiner$ gradle run --args="73"vim src/main/java/lab1/Hello.java
[?1049h[?1h=[2;1H▽[6n[2;1H  [1;1H]11;?[1;24r[?12;25h[?12l[?25h[27m[23m[m[H[2J[?25l[24;1H"src/main/java/lab1/Hello.java" 7L, 134C[>c[1;1H[35mpackage[m lab1;

[32mpublic[m [32mclass[m Hello{
    [32mpublic[m [32mstatic[m [32mvoid[m main(String[] args){[5;9HSystem.out.println([31m"Hello "[m + --args);
    }
}
[94m~                                                                                                            [9;1H~                                                                                                            [10;1H~                                                                                                            [11;1H~                                                                                                            [12;1H~                                                                                                            [13;1H~                                                                                                            [14;1H~                                                                                                            [15;1H~                                                                                                            [16;1H~                                                                                                            [17;1H~                                                                                                            [18;1H~                                                                                                            [19;1H~                                                                                                            [20;1H~                                                                                                            [21;1H~                                                                                                            [22;1H~                                                                                                            [23;1H~                                                                                                            [m[24;92H1,1[11CAll]2;Hello.java (~/csci241/lab-1-trenthiner/src/main/java/lab1) - VIM]1;Hello.java[1;1H[?12l[?25h[27m[23m[m[H[2J[?25l[1;1H[38;5;81mpackage[m lab1;

[38;5;121mpublic[m [38;5;121mclass[m Hello{
    [38;5;121mpublic[m [38;5;121mstatic[m [38;5;121mvoid[m main(String[] args){[5;9HSystem.out.println([95m"Hello "[m + --args);
    }
}
[94m~                                                                                                            [9;1H~                                                                                                            [10;1H~                                                                                                            [11;1H~                                                                                                            [12;1H~                                                                                                            [13;1H~                                                                                                            [14;1H~                                                                                                            [15;1H~                                                                                                            [16;1H~                                                                                                            [17;1H~                                                                                                            [18;1H~                                                                                                            [19;1H~                                                                                                            [20;1H~                                                                                                            [21;1H~                                                                                                            [22;1H~                                                                                                            [23;1H~                                                                                                            [m[24;92H1,1[11CAll"src/main/java/lab1/Hello.java" 7L, 134C[1;1HP+q436f\P+q6b75\P+q6b64\P+q6b72\P+q6b6c\P+q2332\P+q2334\P+q2569\P+q2a37\P+q6b31\[?12l[?25h[?25l[24;92H2,0-1[2;1H[?12l[?25h[?25l[24;92H3,1  [3;1H[?12l[?25h[?25l[24;92H4[4;1H[?12l[?25h[?25l[24;92H5[5;1H[?12l[?25h[?25l[24;94H2[5;2H[?12l[?25h[?25l[24;94H3[5;3H[?12l[?25h[?25l[24;94H4[5;4H[?12l[?25h[?25l[24;94H5[5;5H[?12l[?25h[?25l[24;94H6[5;6H[?12l[?25h[?25l[24;94H7[5;7H[?12l[?25h[?25l[24;94H8[5;8H[?12l[?25h[?25l[24;94H9[5;9H[?12l[?25h[?25l[24;94H10[5;10H[?12l[?25h[?25l[24;95H1[5;11H[?12l[?25h[?25l[24;95H2[5;12H[?12l[?25h[?25l[24;95H3[5;13H[?12l[?25h[?25l[24;95H4[5;14H[?12l[?25h[?25l[24;95H5[5;15H[?12l[?25h[?25l[24;95H6[5;16H[?12l[?25h[?25l[24;95H7[5;17H[?12l[?25h[?25l[24;95H8[5;18H[?12l[?25h[?25l[24;95H9[5;19H[?12l[?25h[?25l[24;94H20[5;20H[?12l[?25h[?25l[24;95H1[5;21H[?12l[?25h[?25l[24;95H2[5;22H[?12l[?25h[?25l[24;95H3[5;23H[?12l[?25h[?25l[24;95H4[5;24H[?12l[?25h[?25l[24;95H5[5;25H[?12l[?25h[?25l[24;95H6[5;26H[?12l[?25h[?25ln[46m([17C)[m[24;95H7[5;27H[?12l[?25h[?25l([17C)[24;95H8[5;28H[?12l[?25h[?25l[24;95H9[5;29H[?12l[?25h[?25l[24;94H30[5;30H[?12l[?25h[?25l[24;95H1[5;31H[?12l[?25h[?25l[24;95H2[5;32H[?12l[?25h[?25l[24;95H3[5;33H[?12l[?25h[?25l[24;95H4[5;34H[?12l[?25h[?25l[24;95H5[5;35H[?12l[?25h[?25l[24;95H6[5;36H[?12l[?25h[?25l[24;95H7[5;37H[?12l[?25h[?25l[24;95H8[5;38H[?12l[?25h[?25l[24;95H9[5;39H[?12l[?25h[?25l[24;94H40[5;40H[?12l[?25h[?25largs);[5;46H[K]2;Hello.java + (~/csci241/lab-1-trenthiner/src/main/java/lab1) - VIM]1;Hello.java[5;40H[?12l[?25h[?25l[24;94H39[5;39H[?12l[?25h[?25largs);[5;45H[K[5;39H[?12l[?25h[?25l[24;95H8[5;38H[?12l[?25h[?25l[24;1H[K[24;1H:[?12l[?25hw[?25l[?12l[?25hq[?25l[?12l[?25h[?25l"src/main/java/lab1/Hello.java" 7L, 132C written]2;Terminal]1;Terminal
[?1l>[?12l[?25h[?1049lhinert@CF165-18:~/csci241/lab-1-trenthiner$ vim src/main/java/lab1/Hello.java[11Pgradle run --args="73"
[0m

[2A[1m<[0;32;1m=========[0;39;1m----> 75% EXECUTING [0s][m[34D[1B[1m> :run[m[6D[1B[2A[0K
[1m> Task :run[m
Hello [Ljava.lang.String;@4aa298b7

[32;1mBUILD SUCCESSFUL[0;39m in 0s
2 actionable tasks: 2 executed
[0K
[0K
[2A[1m<[0;32;1;0;39;1m-------------> 0% WAITING[m[26D[1B[1m> :run[m[6D[1B[2A[2K[1B[2K[1A[0mhinert@CF165-18:~/csci241/lab-1-trenthiner$ gradle run --args="73"vim src/main/java/lab1/Hello.java[11Pgradle run --args="73"vim src/main/java/lab1/Hello.java
[?1049h[?1h=[2;1H▽[6n[2;1H  [1;1H]11;?[1;24r[?12;25h[?12l[?25h[27m[23m[m[H[2J[?25l[24;1H"src/main/java/lab1/Hello.java" 7L, 132C[>c[27m[23m[m[H[2J[1;1H[38;5;81mpackage[m lab1;

[38;5;121mpublic[m [38;5;121mclass[m Hello{
    [38;5;121mpublic[m [38;5;121mstatic[m [38;5;121mvoid[m main(String[] args){[5;9HSystem.out.println([95m"Hello "[m + args);
    }
}
[94m~                                                                                                            [9;1H~                                                                                                            [10;1H~                                                                                                            [11;1H~                                                                                                            [12;1H~                                                                                                            [13;1H~                                                                                                            [14;1H~                                                                                                            [15;1H~                                                                                                            [16;1H~                                                                                                            [17;1H~                                                                                                            [18;1H~                                                                                                            [19;1H~                                                                                                            [20;1H~                                                                                                            [21;1H~                                                                                                            [22;1H~                                                                                                            [23;1H~                                                                                                            [m[24;92H1,1[11CAll"src/main/java/lab1/Hello.java" 7L, 132C[51C   [11C   [1;1H]2;Hello.java (~/csci241/lab-1-trenthiner/src/main/java/lab1) - VIM]1;Hello.java[?12l[?25hP+q436f\P+q6b75\P+q6b64\P+q6b72\P+q6b6c\P+q2332\P+q2334\P+q2569\P+q2a37\P+q6b31\[?25l[24;92H2,0-1[9CAll[2;1H[?12l[?25h[?25l[24;92H3,1  [3;1H[?12l[?25h[?25l[24;92H4[4;1H[?12l[?25h[?25l[24;92H5[5;1H[?12l[?25h[?25l[24;94H2[5;2H[?12l[?25h[?25l[24;94H3[5;3H[?12l[?25h[?25l[24;94H4[5;4H[?12l[?25h[?25l[24;94H5[5;5H[?12l[?25h[?25l[24;94H6[5;6H[?12l[?25h[?25l[24;94H7[5;7H[?12l[?25h[?25l[24;94H8[5;8H[?12l[?25h[?25l[24;94H9[5;9H[?12l[?25h[?25l[24;94H10[5;10H[?12l[?25h[?25l[24;95H1[5;11H[?12l[?25h[?25l[24;95H2[5;12H[?12l[?25h[?25l[24;95H3[5;13H[?12l[?25h[?25l[24;95H4[5;14H[?12l[?25h[?25l[24;95H5[5;15H[?12l[?25h[?25l[24;95H6[5;16H[?12l[?25h[?25l[24;95H7[5;17H[?12l[?25h[?25l[24;95H8[5;18H[?12l[?25h[?25l[24;95H9[5;19H[?12l[?25h[?25l[24;94H20[5;20H[?12l[?25h[?25l[24;95H1[5;21H[?12l[?25h[?25l[24;95H2[5;22H[?12l[?25h[?25l[24;95H3[5;23H[?12l[?25h[?25l[24;95H4[5;24H[?12l[?25h[?25l[24;95H5[5;25H[?12l[?25h[?25l[24;95H6[5;26H[?12l[?25h[?25ln[46m([15C)[m[24;95H7[5;27H[?12l[?25h[?25l([15C)[24;95H8[5;28H[?12l[?25h[?25l[24;95H9[5;29H[?12l[?25h[?25l[24;94H30[5;30H[?12l[?25h[?25l[24;95H1[5;31H[?12l[?25h[?25l[24;95H2[5;32H[?12l[?25h[?25l[24;95H3[5;33H[?12l[?25h[?25l[24;95H4[5;34H[?12l[?25h[?25l[24;95H5[5;35H[?12l[?25h[?25l[24;95H6[5;36H[?12l[?25h[?25l[24;95H7[5;37H[?12l[?25h[?25l[24;95H8[5;38H[?12l[?25h[?25l[24;1H[1m-- INSERT --[m[24;13H[K[24;92H5,38[10CAll[5;38H[?12l[?25h[?25lT args);[24;95H9]2;Hello.java + (~/csci241/lab-1-trenthiner/src/main/java/lab1) - VIM]1;Hello.java[5;39H[?12l[?25h[?25lo args);[24;94H40[5;40H[?12l[?25h[?25l args);[5;46H[K[24;94H39[5;39H[?12l[?25h[?25l args);[5;45H[K[24;95H8[5;38H[?12l[?25h[?25l  args);[24;95H9[5;39H[?12l[?25h[?25lS args);[24;94H40[5;40H[?12l[?25h[?25l args);[5;46H[K[24;94H39[5;39H[?12l[?25h[?25lt args);[24;94H40[5;40H[?12l[?25h[?25l args);[5;46H[K[24;94H39[5;39H[?12l[?25h[?25lT args);[24;94H40[5;40H[?12l[?25h[?25lo args);[24;95H1[5;41H[?12l[?25h[?25lS args);[24;95H2[5;42H[?12l[?25h[?25lT args);[24;95H3[5;43H[?12l[?25h[?25lr args);[24;95H4[5;44H[?12l[?25h[?25li args);[24;95H5[5;45H[?12l[?25h[?25ln args);[24;95H6[5;46H[?12l[?25h[?25lg args);[24;95H7[5;47H[?12l[?25h[?25l args);[5;53H[K[24;95H6[5;46H[?12l[?25h[?25l args);[5;52H[K[24;95H5[5;45H[?12l[?25h[?25l args);[5;51H[K[24;95H4[5;44H[?12l[?25h[?25l args);[5;50H[K[24;95H3[5;43H[?12l[?25h[?25l args);[5;49H[K[24;95H2[5;42H[?12l[?25h[?25lt args);[24;95H3[5;43H[?12l[?25h[?25lr args);[24;95H4[5;44H[?12l[?25h[?25li args);[24;95H5[5;45H[?12l[?25h[?25ln args);[24;95H6[5;46H[?12l[?25h[?25lg args);[24;95H7[5;47H[?12l[?25h[?25l[24;95H8[5;48H[?12l[?25h[?25l[24;95H9[5;49H[?12l[?25h[?25l[24;94H50[5;50H[?12l[?25h[?25l[24;95H1[5;51H[?12l[?25h[?25l);[5;53H[K[5;27H[46m([23C)[?12l[?25h[?25l;[m[5;52H[K[5;27H([23C;[?12l[?25h[?25l[5;51H[K[5;51H[?12l[?25h[?25l[5;23r[23;1H
[1;24r[5;5H    System.out.println([95m"Hello "[m + ToString arg    }[23;1H[94m~                                                                                                            [m[24;92H[K[24;92H5,51[10CAll[5;51H[?12l[?25h[?25l[38;5;81m^Z[m    }[24;95H2-53[5;53H[?12l[?25h[?25l[38;5;81m^Z[m    }[24;95H3-55[5;55H[?12l[?25h[?25l[38;5;81m^Z[m    }[24;95H4-57[5;57H[?12l[?25h[24;1H[K[5;56H[?25l[24;92H5,53-55[7CAll[5;55H[?12l[?25h[?25l[24;92H[K[24;1H:[?12l[?25hq[?25l[?12l[?25h[?25l[97m[41mE37: No write since last change (add ! to override)[m[40C5,53-55[7CAll[5;55H[?12l[?25h[?25l[24;95H4-57[5;57H[?12l[?25h[?25l[24;95H5-58[5;58H[?12l[?25h[?25l[3;19H[46m{


}[m[24;92H6,1    [6;1H[?12l[?25h[?25l[24;1H[1m-- INSERT --[m[24;13H[K[24;92H6,1[11CAll[6;1H[?12l[?25h[?25l[3;19H{


}[24;92H5[5;1H[?12l[?25h[?25l[24;94H2[5;2H[?12l[?25h[?25l[24;94H3[5;3H[?12l[?25h[?25l[24;94H4[5;4H[?12l[?25h[?25l[24;94H5[5;5H[?12l[?25h[?25l[24;94H6[5;6H[?12l[?25h[?25l[24;94H7[5;7H[?12l[?25h[?25l[24;94H8[5;8H[?12l[?25h[?25l[24;94H9[5;9H[?12l[?25h[?25l[24;94H10[5;10H[?12l[?25h[?25l[24;95H1[5;11H[?12l[?25h[?25l[24;95H2[5;12H[?12l[?25h[?25l[24;95H3[5;13H[?12l[?25h[?25l[24;95H4[5;14H[?12l[?25h[?25l[24;95H5[5;15H[?12l[?25h[?25l[24;95H6[5;16H[?12l[?25h[?25l[24;95H7[5;17H[?12l[?25h[?25l[24;95H8[5;18H[?12l[?25h[?25l[24;95H9[5;19H[?12l[?25h[?25l[24;94H20[5;20H[?12l[?25h[?25l[24;95H1[5;21H[?12l[?25h[?25l[24;95H2[5;22H[?12l[?25h[?25l[24;95H3[5;23H[?12l[?25h[?25l[24;95H4[5;24H[?12l[?25h[?25l[24;95H5[5;25H[?12l[?25h[?25l[24;95H6[5;26H[?12l[?25h[?25l[24;95H7[5;27H[?12l[?25h[?25l[24;95H8[5;28H[?12l[?25h[?25l[24;95H9[5;29H[?12l[?25h[?25l[24;94H30[5;30H[?12l[?25h[?25l[24;95H1[5;31H[?12l[?25h[?25l[24;95H2[5;32H[?12l[?25h[?25l[24;95H3[5;33H[?12l[?25h[?25l[24;95H4[5;34H[?12l[?25h[?25l[24;95H5[5;35H[?12l[?25h[?25l[24;95H6[5;36H[?12l[?25h[?25l[24;95H7[5;37H[?12l[?25h[?25l[24;95H8[5;38H[?12l[?25h[?25l[24;95H9[5;39H[?12l[?25h[?25l[24;94H40[5;40H[?12l[?25h[?25l[24;95H1[5;41H[?12l[?25h[?25l[24;95H2[5;42H[?12l[?25h[?25l[24;95H3[5;43H[?12l[?25h[?25l[24;95H4[5;44H[?12l[?25h[?25l[24;95H5[5;45H[?12l[?25h[?25l[24;95H6[5;46H[?12l[?25h[?25l[24;95H7[5;47H[?12l[?25h[?25l[24;95H8[5;48H[?12l[?25h[?25l[24;95H9[5;49H[?12l[?25h[?25l[24;94H50[5;50H[?12l[?25h[?25l[24;95H1[5;51H[?12l[?25h[?25l[24;95H2-53[5;53H[?12l[?25h[?25l[24;95H3-55[5;55H[?12l[?25h[?25l[24;95H4-57[5;57H[?12l[?25h[?25l[24;95H5-58[5;58H[?12l[?25h[?25l[24;95H6-59[5;59H[?12l[?25h[?25l[24;95H7-60[5;60H[?12l[?25h[?25l[4;43H[46m{[5;61H}[m[24;95H8-61[5;61H[?12l[?25h[?25l[24;95H9-62[5;62H[?12l[?25h[?25l[24;95H8-61[5;61H[?12l[?25h[?25l[4;43H{[5;61H}[24;95H7-60[5;60H[?12l[?25h[?25l[6;23r[6;1H[L[1;24r[5;61H[K[6;2H}[24;92H[K[24;92H6,1[11CAll[6;1H[?12l[?25h[?25l[24;92H5[5;1H[?12l[?25h[?25l[24;94H2[5;2H[?12l[?25h[?25l[24;94H3[5;3H[?12l[?25h[?25l[24;94H4[5;4H[?12l[?25h[?25l[24;94H5[5;5H[?12l[?25h[?25l[24;94H6[5;6H[?12l[?25h[?25l[24;94H7[5;7H[?12l[?25h[?25l[24;94H8[5;8H[?12l[?25h[?25l[24;94H9[5;9H[?12l[?25h[?25l[24;94H10[5;10H[?12l[?25h[?25l[24;95H1[5;11H[?12l[?25h[?25l[24;95H2[5;12H[?12l[?25h[?25l[24;95H3[5;13H[?12l[?25h[?25l[24;95H4[5;14H[?12l[?25h[?25l[24;95H5[5;15H[?12l[?25h[?25l[24;95H6[5;16H[?12l[?25h[?25l[24;95H7[5;17H[?12l[?25h[?25l[24;95H8[5;18H[?12l[?25h[?25l[24;95H9[5;19H[?12l[?25h[?25l[24;94H20[5;20H[?12l[?25h[?25l[24;95H1[5;21H[?12l[?25h[?25l[24;95H2[5;22H[?12l[?25h[?25l[24;95H3[5;23H[?12l[?25h[?25l[24;95H4[5;24H[?12l[?25h[?25l[24;95H5[5;25H[?12l[?25h[?25l[24;95H6[5;26H[?12l[?25h[?25l[24;95H7[5;27H[?12l[?25h[?25l[24;95H8[5;28H[?12l[?25h[?25l[24;95H9[5;29H[?12l[?25h[?25l[24;94H30[5;30H[?12l[?25h[?25l[24;95H1[5;31H[?12l[?25h[?25l[24;95H2[5;32H[?12l[?25h[?25l[24;95H3[5;33H[?12l[?25h[?25l[24;95H4[5;34H[?12l[?25h[?25l[24;95H5[5;35H[?12l[?25h[?25l[24;95H6[5;36H[?12l[?25h[?25l[24;95H7[5;37H[?12l[?25h[?25l[24;95H8[5;38H[?12l[?25h[?25l[24;95H9[5;39H[?12l[?25h[?25l[24;94H40[5;40H[?12l[?25h[?25l[24;95H1[5;41H[?12l[?25h[?25l[24;95H2[5;42H[?12l[?25h[?25l[24;95H3[5;43H[?12l[?25h[?25l[24;95H4[5;44H[?12l[?25h[?25l[24;95H5[5;45H[?12l[?25h[?25l[24;95H6[5;46H[?12l[?25h[?25l[24;95H7[5;47H[?12l[?25h[?25l[24;95H8[5;48H[?12l[?25h[?25l[24;95H9[5;49H[?12l[?25h[?25l[24;94H50[5;50H[?12l[?25h[?25l[24;95H1[5;51H[?12l[?25h[?25l[24;95H2-53[5;53H[?12l[?25h[?25l[24;95H3-55[5;55H[?12l[?25h[?25l[24;95H4-57[5;57H[?12l[?25h[?25l[24;95H5-58[5;58H[?12l[?25h[?25l[24;95H4-57[5;57H[?12l[?25h[?25l[24;95H3-55[5;55H[?12l[?25h[?25l  [24;95H2-53[5;53H[?12l[?25h[?25l  [24;95H1   [5;51H[?12l[?25h[?25l[24;95H2-53[5;53H[?12l[?25h[?25l  [24;95H1   [5;51H[?12l[?25h[?25l [24;95H0[5;50H[?12l[?25h[?25l [24;94H49[5;49H[?12l[?25h[?25l [24;95H8[5;48H[?12l[?25h[?25l[24;95H7[5;47H[?12l[?25h[?25l [24;95H6[5;46H[?12l[?25h[?25l [24;95H5[5;45H[?12l[?25h[?25l [24;95H4[5;44H[?12l[?25h[?25l [24;95H3[5;43H[?12l[?25h[?25l [24;95H2[5;42H[?12l[?25h[?25l [24;95H1[5;41H[?12l[?25h[?25l [24;95H0[5;40H[?12l[?25h[?25l [24;94H39[5;39H[?12l[?25h[?25l[24;95H8[5;38H[?12l[?25h[?25l[24;95H9[5;39H[?12l[?25h[?25la[24;94H40[5;40H[?12l[?25h[?25lr[24;95H1[5;41H[?12l[?25h[?25lg[24;95H2[5;42H[?12l[?25h[?25ls[24;95H3[5;43H[?12l[?25h[?25l[[24;95H4[5;44H[?12l[?25h[?25l[95m0[m[24;95H5[5;45H[?12l[?25h[?25l][46m[[1C][m[24;95H6[5;46H[?12l[?25h[?25l)[5;27H[46m([m[15C[[1C][46m)[m[24;95H7[5;47H[?12l[?25h[?25l;[5;27H([18C)[24;95H8[5;48H[?12l[?25h[24;1H[K[5;47H[?25l[24;92H5,47[10CAll[5;47H[?12l[?25h[?25l[24;92H[K[24;1H:[?12l[?25hw[?25l[?12l[?25hq[?25l[?12l[?25h[?25l"src/main/java/lab1/Hello.java" 7L, 135C written]2;Terminal]1;Terminal
[?1l>[?12l[?25h[?1049lhinert@CF165-18:~/csci241/lab-1-trenthiner$ vim src/main/java/lab1/Hello.java[11Pgradle run --args="73"
[0m

[2A[1m<[0;32;1m=========[0;39;1m----> 75% EXECUTING [0s][m[34D[1B[1m> :run[m[6D[1B[2A[0K
[1m> Task :run[m
Hello 73

[32;1mBUILD SUCCESSFUL[0;39m in 0s
2 actionable tasks: 2 executed
[0K
[0K
[2A[1m<[0;32;1;0;39;1m-------------> 0% WAITING[m[26D[1B[1m> :run[m[6D[1B[2A[2K[1B[2K[1A[0mhinert@CF165-18:~/csci241/lab-1-trenthiner$ gradle run --args="73"vim src/main/java/lab1/Hello.java
[?1049h[?1h=[2;1H▽[6n[2;1H  [1;1H]11;?[1;24r[?12;25h[?12l[?25h[27m[23m[m[H[2J[?25l[24;1H"src/main/java/lab1/Hello.java" 7L, 135C[>c[1;1H[35mpackage[m lab1;

[32mpublic[m [32mclass[m Hello{
    [32mpublic[m [32mstatic[m [32mvoid[m main(String[] args){[5;9HSystem.out.println([31m"Hello "[m + args[[31m0[m]);
 }
}
[94m~                                                                                                            [9;1H~                                                                                                            [10;1H~                                                                                                            [11;1H~                                                                                                            [12;1H~                                                                                                            [13;1H~                                                                                                            [14;1H~                                                                                                            [15;1H~                                                                                                            [16;1H~                                                                                                            [17;1H~                                                                                                            [18;1H~                                                                                                            [19;1H~                                                                                                            [20;1H~                                                                                                            [21;1H~                                                                                                            [22;1H~                                                                                                            [23;1H~                                                                                                            [m[24;92H1,1[11CAll]2;Hello.java (~/csci241/lab-1-trenthiner/src/main/java/lab1) - VIM]1;Hello.java[1;1H[?12l[?25h[27m[23m[m[H[2J[?25l[1;1H[38;5;81mpackage[m lab1;

[38;5;121mpublic[m [38;5;121mclass[m Hello{
    [38;5;121mpublic[m [38;5;121mstatic[m [38;5;121mvoid[m main(String[] args){[5;9HSystem.out.println([95m"Hello "[m + args[[95m0[m]);
 }
}
[94m~                                                                                                            [9;1H~                                                                                                            [10;1H~                                                                                                            [11;1H~                                                                                                            [12;1H~                                                                                                            [13;1H~                                                                                                            [14;1H~                                                                                                            [15;1H~                                                                                                            [16;1H~                                                                                                            [17;1H~                                                                                                            [18;1H~                                                                                                            [19;1H~                                                                                                            [20;1H~                                                                                                            [21;1H~                                                                                                            [22;1H~                                                                                                            [23;1H~                                                                                                            [m[24;92H1,1[11CAll"src/main/java/lab1/Hello.java" 7L, 135C[1;1HP+q436f\P+q6b75\P+q6b64\P+q6b72\P+q6b6c\P+q2332\P+q2334\P+q2569\P+q2a37\P+q6b31\[?12l[?25h[?25l[24;92H2,0-1[2;1H[?12l[?25h[?25l[24;92H3,1  [3;1H[?12l[?25h[?25l[24;92H4[4;1H[?12l[?25h[?25l[24;92H5[5;1H[?12l[?25h[?25l[24;92H6[6;1H[?12l[?25h[?25l[4;43H[46m{

[m [46m}[m[24;94H2[6;2H[?12l[?25h[?25l[4;43H{

 }[24;92H5[5;2H[?12l[?25h[?25l[24;94H3[5;3H[?12l[?25h[?25l[24;94H4[5;4H[?12l[?25h[?25l[24;94H5[5;5H[?12l[?25h[?25l[24;94H6[5;6H[?12l[?25h[?25l[24;94H7[5;7H[?12l[?25h[?25l[24;94H8[5;8H[?12l[?25h[?25l[24;94H9[5;9H[?12l[?25h[?25l[24;94H10[5;10H[?12l[?25h[?25l[24;95H1[5;11H[?12l[?25h[?25l[24;95H2[5;12H[?12l[?25h[?25l[24;95H3[5;13H[?12l[?25h[?25l[24;95H4[5;14H[?12l[?25h[?25l[24;95H5[5;15H[?12l[?25h[?25l[24;95H6[5;16H[?12l[?25h[?25l[24;95H7[5;17H[?12l[?25h[?25l[24;95H8[5;18H[?12l[?25h[?25l[24;95H9[5;19H[?12l[?25h[?25l[24;94H20[5;20H[?12l[?25h[?25l[24;95H1[5;21H[?12l[?25h[?25l[24;95H2[5;22H[?12l[?25h[?25l[24;95H3[5;23H[?12l[?25h[?25l[24;95H4[5;24H[?12l[?25h[?25l[24;95H5[5;25H[?12l[?25h[?25l[24;95H6[5;26H[?12l[?25h[?25ln[46m([18C)[m[24;95H7[5;27H[?12l[?25h[?25l([18C)[24;95H8[5;28H[?12l[?25h[?25l[24;95H9[5;29H[?12l[?25h[?25l[24;94H30[5;30H[?12l[?25h[?25l[24;95H1[5;31H[?12l[?25h[?25l[24;95H2[5;32H[?12l[?25h[?25l[24;95H3[5;33H[?12l[?25h[?25l[24;95H4[5;34H[?12l[?25h[?25l[24;95H5[5;35H[?12l[?25h[?25l[24;95H6[5;36H[?12l[?25h[?25l[24;95H7[5;37H[?12l[?25h[?25l[24;95H8[5;38H[?12l[?25h[?25l[24;95H9[5;39H[?12l[?25h[?25l[24;94H40[5;40H[?12l[?25h[?25l[24;95H1[5;41H[?12l[?25h[?25l[24;95H2[5;42H[?12l[?25h[?25ls[46m[[1C][m[24;95H3[5;43H[?12l[?25h[?25l[[1C][24;95H4[5;44H[?12l[?25h[?25l[46m[[1C][m[24;95H5[5;45H[?12l[?25h[?25l[5;27H[46m([m[15C[[1C][46m)[m[24;95H6[5;46H[?12l[?25h[?25l[4;43H[46m{[m[5;27H([18C)
 [46m}[m[24;92H6,2 [6;2H[?12l[?25h[?25l[24;1H[1m-- INSERT --[m[24;13H[K[24;92H6,2[11CAll[6;2H[?12l[?25h[?25l[4;43H{

 }[24;92H5[5;2H[?12l[?25h[?25l[24;94H3[5;3H[?12l[?25h[?25l[24;94H4[5;4H[?12l[?25h[?25l[24;94H5[5;5H[?12l[?25h[?25l[24;94H6[5;6H[?12l[?25h[?25l[24;94H7[5;7H[?12l[?25h[?25l[24;94H8[5;8H[?12l[?25h[?25l[24;94H9[5;9H[?12l[?25h[?25l[24;94H10[5;10H[?12l[?25h[?25l[24;95H1[5;11H[?12l[?25h[?25l[24;95H2[5;12H[?12l[?25h[?25l[24;95H3[5;13H[?12l[?25h[?25l[24;95H4[5;14H[?12l[?25h[?25l[24;95H5[5;15H[?12l[?25h[?25l[24;95H6[5;16H[?12l[?25h[?25l[24;95H7[5;17H[?12l[?25h[?25l[24;95H8[5;18H[?12l[?25h[?25l[24;95H9[5;19H[?12l[?25h[?25l[24;94H20[5;20H[?12l[?25h[?25l[24;95H1[5;21H[?12l[?25h[?25l[24;95H2[5;22H[?12l[?25h[?25l[24;95H3[5;23H[?12l[?25h[?25l[24;95H4[5;24H[?12l[?25h[?25l[24;95H5[5;25H[?12l[?25h[?25l[24;95H6[5;26H[?12l[?25h[?25ln[46m([18C)[m[24;95H7[5;27H[?12l[?25h[?25l[24;95H8[5;28H[?12l[?25h[?25l([18C)[24;95H9[5;29H[?12l[?25h[?25l[24;94H30[5;30H[?12l[?25h[?25l[24;95H1[5;31H[?12l[?25h[?25l[24;95H2[5;32H[?12l[?25h[?25l[24;95H3[5;33H[?12l[?25h[?25l[24;95H4[5;34H[?12l[?25h[?25l[24;95H5[5;35H[?12l[?25h[?25l[24;95H6[5;36H[?12l[?25h[?25l[24;95H7[5;37H[?12l[?25h[?25l[24;95H8[5;38H[?12l[?25h[?25l[24;95H9[5;39H[?12l[?25h[?25l[24;94H40[5;40H[?12l[?25h[?25l[24;95H1[5;41H[?12l[?25h[?25l[24;95H2[5;42H[?12l[?25h[?25ls[46m[[1C][m[24;95H3[5;43H[?12l[?25h[?25l[24;95H4[5;44H[?12l[?25h[?25l[24;95H5[5;45H[?12l[?25h[?25l[5;27H[46m([m[15C[[1C][46m)[m[24;95H6[5;46H[?12l[?25h[?25l[46m+[m);+[46m)[m[24;95H7]2;Hello.java + (~/csci241/lab-1-trenthiner/src/main/java/lab1) - VIM]1;Hello.java[5;47H[?12l[?25h[?25l[46m [m); [46m)[m[24;95H8[5;48H[?12l[?25h[?25l[95m[46m"[m[95m);   "[m[95m[46m)[m[24;95H9[5;49H[?12l[?25h[?25l[95m[46m![m[95m);   ![m[95m[46m)[m[24;94H50[5;50H[?12l[?25h[?25l[95m[46m"[m);  [95m"[m[46m)[m[24;95H1[5;51H[?12l[?25h[?25l[5;27H([23C)[24;95H0[5;50H[?12l[?25h[?25l[24;94H49[5;49H[?12l[?25h[?25l[24;95H8[5;48H[?12l[?25h[?25l[24;95H7[5;47H[?12l[?25h[?25l[46m[[1C][m[24;95H6[5;46H[?12l[?25h[?25l + [95m"!"[m);[5;43H[[1C][24;95H7[5;47H[?12l[?25h[?25l[24;95H8[5;48H[?12l[?25h[24;1H[K[5;47H[?25l[24;92H5,47[10CAll[5;47H[?12l[?25h[?25l[24;92H[K[24;1H:[?12l[?25hw[?25l[?12l[?25hq[?25l[?12l[?25h[?25l"src/main/java/lab1/Hello.java" 7L, 141C written]2;Terminal]1;Terminal
[?1l>[?12l[?25h[?1049lhinert@CF165-18:~/csci241/lab-1-trenthiner$ vim src/main/java/lab1/Hello.java[11Pgradle run --args="73"
[0m

[1A[1m> Connecting to Daemon[m[22D[1B[2A[1m<[0;32;1;0;39;1m-------------> 0% EXECUTING [0s][m[33D[1B[1m> :compileJava[m[0K[14D[1B[2A[0K
[1m> Task :run[m[0K
Hello 73!

[32;1mBUILD SUCCESSFUL[0;39m in 0s
2 actionable tasks: 2 executed
[0K
[0K
[2A[1m<[0;32;1;0;39;1m-------------> 0% WAITING[m[26D[1B[1m> :compileJava[m[14D[1B[2A[2K[1B[2K[1A[0mhinert@CF165-18:~/csci241/lab-1-trenthiner$ add [K[K[K[Kgit add src/main/java/lab1/Hello.java 
hinert@CF165-18:~/csci241/lab-1-trenthiner$ git commit "Hellow W[K[K[K[Ko now [K[Kw prints t[Kcommand line arg"[C[C[1@ [1@-[1@,[1P[1@m[C[1@ [C
[master cb35e13] Hello now prints command line arg
 1 file changed, 2 insertions(+), 2 deletions(-)
hinert@CF165-18:~/csci241/lab-1-trenthiner$ git push
warning: push.default is unset; its implicit value has changed in
Git 2.0 from 'matching' to 'simple'. To squelch this message
and maintain the traditional behavior, use:

  git config --global push.default matching

To squelch this message and adopt the new behavior now, use:

  git config --global push.default simple

When push.default is set to 'matching', git will push local branches
to the remote branches that already exist with the same name.

Since Git 2.0, Git defaults to the more conservative 'simple'
behavior, which only pushes the current branch to the corresponding
remote branch that 'git pull' uses to update the current branch.

See 'git help config' and search for 'push.default' for further information.
(the 'simple' mode was introduced in Git 1.7.11. Use the similar mode
'current' instead of 'simple' if you sometimes use older versions of Git)

Username for 'https://github.com': trenthiner
Password for 'https://trenthiner@github.com': 
Counting objects: 7, done.
Delta compression using up to 8 threads.
Compressing objects:  33% (1/3)   Compressing objects:  66% (2/3)   Compressing objects: 100% (3/3)   Compressing objects: 100% (3/3), done.
Writing objects:  14% (1/7)   Writing objects:  28% (2/7)   Writing objects:  42% (3/7)   Writing objects:  57% (4/7)   Writing objects:  71% (5/7)   Writing objects:  85% (6/7)   Writing objects: 100% (7/7)   Writing objects: 100% (7/7), 487 bytes | 0 bytes/s, done.
Total 7 (delta 2), reused 0 (delta 0)
remote: Resolving deltas:   0% (0/2)   [Kremote: Resolving deltas:  50% (1/2)   [Kremote: Resolving deltas: 100% (2/2)   [Kremote: Resolving deltas: 100% (2/2), completed with 2 local objects.[K
ls
ls
To https://github.com/CSCI241Spring2019/lab-1-trenthiner.git
   accae62..cb35e13  master -> master
hinert@CF165-18:~/csci241/lab-1-trenthiner$ ls
build  build.gradle  src  username.txt	writeup.txt
hinert@CF165-18:~/csci241/lab-1-trenthiner$ ls
build  build.gradle  src  username.txt	writeup.txt
hinert@CF165-18:~/csci241/lab-1-trenthiner$ rm[K[Kext[Kt[Kit
exit

Script done on Thu 11 Apr 2019 01:37:52 PM PDT
